Country,Edition,Status,A1,A2,A3,A4,A5,A: Obstacles to Access,B1,B2,B3,B4,B5,B6,B7,B8,B: Limits on Content,C1,C2,C3,C4,C5,C6,C7,C8,C: Violations of User Rights,Total country score,
Angola,2022,PF,1,1,5,3,1,11,6,3,4,3,3,2,3,5,29,2,1,4,3,2,3,4,2,21,61,
Angola,2021,PF,2,1,5,3,1,12,6,4,4,3,3,2,3,5,30,2,1,4,3,2,3,4,1,20,62,
Angola,2020,PF,1,1,5,3,1,11,6,4,4,3,3,2,3,5,30,2,1,4,3,2,3,4,2,21,62,
Angola,2019,PF,2,1,5,3,1,12,6,4,4,3,3,2,3,5,30,2,1,4,3,3,3,4,2,22,64,
Angola,2018,PF,2,0,5,3,1,11,6,4,4,2,3,2,3,4,28,2,2,3,3,3,3,3,2,21,60,
Angola,2017,PF,2,0,5,3,1,11,6,4,4,2,3,2,3,4,28,2,2,3,3,3,3,3,2,21,60,
Angola,2016,PF,2,0,5,3,1,11,6,4,4,2,3,2,3,4,28,2,2,3,3,3,3,3,2,21,60,
Angola,2015,PF,2,0,5,3,1,11,6,3,4,2,3,2,3,4,27,2,2,4,4,3,3,3,2,23,61,
Angola,2014,PF,1,0,5,3,1,10,6,4,4,2,3,2,3,4,28,2,2,4,4,4,3,3,2,24,62,
Angola,2013,PF,1,0,5,3,1,10,6,4,4,3,3,2,3,4,29,2,2,6,3,5,4,3,2,27,66,
Argentina,2022,F,5,2,6,4,2,19,5,2,3,3,3,2,3,6,27,4,2,5,2,3,4,4,1,25,71,
Argentina,2021,F,5,2,6,4,2,19,5,2,3,3,3,2,3,6,27,4,2,4,2,3,4,4,2,25,71,
Argentina,2020,F,5,2,6,4,2,19,5,2,3,3,3,2,3,6,27,4,2,4,2,4,4,4,1,25,71,
Argentina,2019,F,5,2,6,4,2,19,5,2,3,3,3,2,3,5,26,4,2,5,2,4,4,4,2,27,72,
Argentina,2018,F,5,2,6,4,2,19,5,3,3,3,3,2,3,5,27,4,2,5,2,4,4,4,1,26,72,
Argentina,2017,F,5,2,6,4,2,19,5,3,3,3,4,2,3,5,28,4,2,5,2,4,4,4,1,26,73,
Argentina,2016,F,5,2,6,4,2,19,5,3,3,3,4,2,2,4,26,4,2,5,3,4,4,4,2,28,73,
Argentina,2015,F,4,2,6,4,2,18,5,3,3,3,4,2,3,4,27,4,2,5,3,4,4,4,2,28,73,
Argentina,2014,F,4,2,6,4,2,18,5,2,3,3,4,2,3,4,26,4,2,5,3,4,5,4,2,29,73,
Argentina,2013,F,4,2,6,3,2,17,5,2,2,3,4,2,3,4,25,4,2,6,3,5,5,3,3,31,73,
Argentina,2012,F,4,2,5,3,2,16,5,2,3,3,4,3,3,3,26,4,2,6,3,5,5,4,3,32,74,
Armenia,2022,F,5,2,6,5,2,20,6,2,3,3,2,3,3,6,28,3,2,4,3,3,5,4,2,26,74,
Armenia,2021,F,5,2,5,5,2,19,4,2,3,3,2,3,3,6,26,3,3,4,3,3,5,4,1,26,71,
Armenia,2020,F,5,2,6,5,2,20,6,2,3,3,2,3,3,6,28,3,3,5,3,3,4,4,2,27,75,
Armenia,2019,F,5,2,6,5,2,20,6,3,3,3,2,3,3,6,29,3,3,5,3,3,5,3,2,27,76,
Armenia,2018,F,5,2,6,5,2,20,5,3,3,3,2,2,3,6,27,3,3,5,3,3,5,2,2,26,73,
Armenia,2017,PF,4,2,5,5,2,18,4,3,3,3,2,2,3,5,25,3,3,5,3,3,5,2,1,25,68,
Armenia,2016,F,4,2,6,5,2,19,5,3,3,2,2,2,3,5,25,3,3,5,3,3,5,2,2,26,70,
Armenia,2015,F,4,2,6,5,2,19,5,2,3,2,3,2,3,5,25,3,3,5,3,3,5,4,2,28,72,
Armenia,2014,F,4,2,5,5,2,18,5,3,3,2,3,2,3,5,26,3,3,5,3,3,5,4,2,28,72,
Armenia,2013,F,3,2,5,5,2,17,6,3,3,2,3,2,3,4,26,3,3,5,3,3,5,4,2,28,71,
Australia,2022,F,6,2,6,5,4,23,5,2,2,3,3,3,4,6,28,5,2,5,2,2,3,5,1,25,76,
Australia,2021,F,6,2,6,5,4,23,5,2,2,3,3,3,3,6,27,5,2,5,2,2,3,5,1,25,75,
Australia,2020,F,6,2,6,5,4,23,5,2,2,3,3,3,4,6,28,5,2,5,2,2,3,5,1,25,76,
Australia,2019,F,6,2,6,5,4,23,5,2,2,3,4,3,4,6,29,5,2,5,2,2,3,5,1,25,77,
Australia,2018,F,6,2,6,5,4,23,5,2,3,3,4,3,4,5,29,5,2,5,2,2,4,5,2,27,79,
Australia,2017,F,6,2,6,5,4,23,5,2,3,3,4,3,4,5,29,5,2,5,2,2,4,5,2,27,79,
Australia,2016,F,6,2,6,5,4,23,5,2,3,3,4,3,4,5,29,5,2,5,2,2,4,5,2,27,79,
Australia,2015,F,6,2,6,5,4,23,5,3,3,3,4,3,4,5,30,5,2,5,2,3,4,5,2,28,81,
Australia,2014,F,6,2,6,5,4,23,5,3,3,3,4,3,4,5,30,5,2,5,3,4,4,5,2,30,83,
Australia,2013,F,6,2,6,5,4,23,5,3,3,3,4,3,4,5,30,5,2,5,3,4,4,5,2,30,83,
Australia,2012,F,6,2,6,5,4,23,5,3,3,3,4,3,4,5,30,5,2,5,3,5,4,5,2,31,84,
Australia,2011,F,5,2,6,5,4,22,5,3,2,3,4,3,4,5,29,5,2,5,3,5,4,5,3,32,83,
Azerbaijan,2022,NF,5,1,4,2,0,12,3,2,1,2,1,0,2,4,15,1,2,1,3,1,1,2,0,11,38,
Azerbaijan,2021,NF,4,1,3,2,0,10,2,2,1,2,1,0,2,4,14,1,2,1,3,1,1,2,0,11,35,
Azerbaijan,2020,NF,4,1,4,2,0,11,3,2,1,2,1,0,2,4,15,2,2,1,3,1,1,2,0,12,38,
Azerbaijan,2019,NF,4,1,4,2,0,11,3,2,1,2,1,0,2,4,15,2,2,1,3,1,2,2,0,13,39,
Azerbaijan,2018,PF,5,1,4,2,0,12,3,2,1,2,1,0,2,3,14,2,2,1,3,2,2,2,0,14,40,
Azerbaijan,2017,PF,5,1,4,2,0,12,3,2,2,2,1,0,2,3,15,2,2,1,3,2,2,2,1,15,42,
Azerbaijan,2016,PF,4,1,4,2,0,11,4,2,2,2,1,0,2,3,16,2,2,1,3,2,2,2,2,16,43,
Azerbaijan,2015,PF,4,1,5,2,0,12,4,2,2,2,1,0,2,3,16,2,2,1,3,2,2,2,2,16,44,
Azerbaijan,2014,PF,4,1,4,2,0,11,4,2,2,2,2,1,2,3,18,2,2,1,3,2,2,2,2,16,45,
Azerbaijan,2013,PF,4,1,4,3,0,12,4,2,2,2,2,1,2,3,18,2,2,2,3,2,3,2,2,18,48,
Azerbaijan,2012,PF,4,1,4,3,0,12,4,2,2,2,3,1,2,3,19,2,2,3,3,2,4,1,2,19,50,
Azerbaijan,2011,PF,2,1,4,3,0,10,4,3,2,2,3,1,2,3,20,2,2,3,3,3,4,3,2,22,52,
Bahrain,2022,NF,6,2,4,4,0,16,1,0,0,0,0,1,1,3,6,0,0,2,1,1,0,2,1,7,29,
Bahrain,2021,NF,6,2,4,4,0,16,1,0,1,0,0,1,1,4,8,0,0,2,1,1,0,1,1,6,30,
Bahrain,2020,NF,6,2,3,4,0,15,1,0,1,0,0,1,1,4,8,0,0,2,1,1,0,1,1,6,29,
Bahrain,2019,NF,6,2,4,4,0,16,1,0,1,0,0,1,1,4,8,0,0,1,1,1,0,1,1,5,29,
Bahrain,2018,NF,6,2,3,4,0,15,1,0,1,0,0,1,1,4,8,0,0,1,2,1,0,1,1,6,29,
Bahrain,2017,NF,6,2,2,4,0,14,1,0,1,0,0,1,1,4,8,0,0,1,2,1,0,1,1,6,28,
Bahrain,2016,NF,6,2,3,4,0,15,1,0,1,0,0,1,1,4,8,0,0,1,2,1,0,1,1,6,29,
Bahrain,2015,NF,5,2,3,4,0,14,1,0,1,0,0,1,1,4,8,0,0,1,2,1,0,1,1,6,28,
Bahrain,2014,NF,5,2,2,4,0,13,1,0,1,0,0,1,1,4,8,0,0,0,2,1,0,1,1,5,26,
Bahrain,2013,NF,5,2,3,4,0,14,2,0,1,0,0,1,1,4,9,0,0,0,2,1,0,1,1,5,28,
Bahrain,2012,NF,5,2,2,4,0,13,2,0,1,1,0,1,1,4,10,0,0,1,2,2,0,0,1,6,29,
Bahrain,2011,NF,4,2,3,4,1,14,3,1,1,0,0,2,2,4,13,1,0,2,2,2,0,3,1,11,38,
Bangladesh,2022,PF,3,1,3,5,1,13,3,2,1,1,2,2,3,4,18,2,0,2,2,1,2,2,1,12,43,
Bangladesh,2021,PF,2,1,3,5,1,12,3,2,1,1,2,2,3,3,17,2,0,2,2,1,2,1,1,11,40,
Bangladesh,2020,PF,3,1,3,5,1,13,3,2,1,1,2,2,3,3,17,2,0,2,2,2,2,1,1,12,42,
Bangladesh,2019,PF,3,1,3,5,1,13,2,2,1,1,3,2,3,3,17,2,0,2,2,2,2,2,2,14,44,
Bangladesh,2018,PF,2,1,4,5,1,13,4,2,1,1,3,3,3,4,21,2,0,3,2,2,2,2,2,15,49,
Bangladesh,2017,PF,2,1,3,5,1,12,3,2,1,1,3,3,3,4,20,2,0,2,2,2,2,2,2,14,46,
Bangladesh,2016,PF,2,1,2,5,1,11,4,2,1,1,3,3,3,4,21,2,0,2,2,2,2,0,2,12,44,
Bangladesh,2015,PF,2,1,4,5,1,13,4,2,1,2,3,3,3,5,23,2,0,2,3,2,2,0,2,13,49,
Bangladesh,2014,PF,1,1,5,5,1,13,4,2,1,2,3,3,3,5,23,2,0,2,3,2,2,2,2,15,51,
Bangladesh,2013,PF,1,1,4,5,1,12,4,2,1,2,3,3,3,5,23,2,0,3,3,3,2,1,2,16,51,
Belarus,2022,NF,5,2,4,1,0,12,1,1,0,1,2,0,2,3,10,1,1,0,1,1,0,1,1,6,28,
Belarus,2021,NF,5,2,2,1,0,10,2,1,0,2,2,1,2,4,14,1,1,1,1,1,0,1,1,7,31,
Belarus,2020,NF,5,2,4,1,0,12,3,2,0,2,2,1,2,4,16,1,1,2,1,2,0,2,1,10,38,
Belarus,2019,NF,5,2,4,1,0,12,3,1,0,1,2,0,2,4,13,1,1,2,1,2,0,2,1,10,35,
Belarus,2018,NF,5,2,3,1,0,11,3,1,0,1,2,0,2,5,14,1,1,2,1,2,0,3,1,11,36,
Belarus,2017,NF,5,2,3,1,0,11,3,1,0,1,2,0,3,5,15,1,1,2,1,2,0,2,1,10,36,
Belarus,2016,NF,5,2,4,1,0,12,3,1,0,1,2,0,3,4,14,1,1,3,1,2,0,3,1,12,38,
Belarus,2015,NF,4,2,4,0,0,10,3,2,0,1,1,0,3,4,14,1,1,3,1,2,0,3,1,12,36,
Belarus,2014,NF,4,2,4,0,0,10,3,2,0,2,1,0,3,4,15,1,1,4,2,2,0,2,1,13,38,
Belarus,2013,NF,4,2,3,0,0,9,3,2,0,1,1,0,2,4,13,1,1,3,2,2,0,2,0,11,33,
Belarus,2012,NF,4,2,3,0,0,9,3,2,0,1,1,0,2,3,12,1,1,2,2,2,0,2,0,10,31,
Belarus,2011,NF,3,1,2,0,0,6,3,2,0,1,1,0,3,2,12,2,1,3,2,2,0,3,0,13,31,
Brazil,2022,PF,5,1,6,5,3,20,5,2,2,3,1,2,3,6,24,4,2,3,2,3,4,1,2,21,65,
Brazil,2021,PF,5,1,6,5,3,20,5,2,2,3,1,2,3,6,24,4,2,3,2,3,4,1,1,20,64,
Brazil,2020,PF,4,1,6,5,3,19,5,2,2,3,1,2,3,6,24,4,2,4,2,3,4,0,1,20,63,
Brazil,2019,PF,4,1,6,4,3,18,6,2,2,3,2,2,3,6,26,4,2,4,2,3,4,0,1,20,64,
Brazil,2018,PF,4,1,6,4,3,18,6,2,3,3,2,2,4,6,28,5,2,4,2,4,4,0,2,23,69,
Brazil,2017,PF,4,1,5,4,3,17,5,2,3,3,2,2,4,6,27,5,2,4,2,4,4,0,2,23,67,
Brazil,2016,PF,4,1,5,4,3,17,5,3,3,3,2,2,4,6,28,5,2,4,2,4,4,0,2,23,68,
Brazil,2015,F,4,1,6,4,3,18,6,2,4,3,2,2,4,6,29,5,2,4,2,4,4,1,2,24,71,
Brazil,2014,F,4,1,6,4,3,18,6,2,3,3,2,2,4,6,28,5,2,3,2,4,4,2,2,24,70,
Brazil,2013,PF,4,1,6,4,3,18,6,2,3,3,3,2,4,4,27,4,2,3,2,4,4,2,2,23,68,
Brazil,2012,F,4,1,6,4,3,18,6,3,3,3,4,2,4,4,29,4,2,5,2,4,3,4,2,26,73,
Brazil,2011,F,3,1,6,5,3,18,6,2,3,3,4,2,4,4,28,4,2,3,3,4,3,4,2,25,71,
Cambodia,2022,PF,4,1,4,4,0,13,4,1,1,1,2,2,3,4,18,1,1,1,3,2,1,2,1,12,43,
Cambodia,2021,PF,4,1,4,4,0,13,4,1,1,1,2,2,3,4,18,1,1,1,3,2,1,2,1,12,43,
Cambodia,2020,PF,3,1,4,4,0,12,4,1,1,1,2,2,3,4,18,1,1,1,3,2,1,3,1,13,43,
Cambodia,2019,PF,3,1,4,4,0,12,3,2,1,1,2,2,3,4,18,1,1,1,3,2,1,3,1,13,43,
Cambodia,2018,PF,3,1,4,4,0,12,4,2,1,1,2,2,3,4,19,1,1,1,3,2,1,4,1,14,45,
Cambodia,2017,PF,3,1,4,4,0,12,4,2,1,2,2,2,3,4,20,1,2,1,3,3,1,4,1,16,48,
Cambodia,2016,PF,2,1,4,3,0,10,4,2,1,2,2,2,3,4,20,1,2,2,3,3,1,4,2,18,48,
Cambodia,2015,PF,2,1,5,3,0,11,4,2,1,2,2,2,3,4,20,1,2,5,3,3,1,4,2,21,52,
Cambodia,2014,PF,2,1,5,3,0,11,4,2,1,2,2,2,3,4,20,1,2,6,3,3,1,4,2,22,53,
Cambodia,2013,PF,2,1,5,3,0,11,4,2,1,2,2,2,3,4,20,1,2,6,3,3,1,4,2,22,53,
Canada,2022,F,6,2,6,5,4,23,5,3,4,3,4,3,4,6,32,5,2,6,4,4,4,5,2,32,87,
Canada,2021,F,6,2,6,5,4,23,5,3,4,3,4,3,4,6,32,5,2,6,4,4,4,5,2,32,87,
Canada,2020,F,6,2,6,5,4,23,5,3,4,3,4,3,4,6,32,5,2,6,4,4,4,5,2,32,87,
Canada,2019,F,6,2,6,5,4,23,6,3,4,3,4,3,4,6,33,5,2,6,4,3,4,5,2,31,87,
Canada,2018,F,6,2,6,5,4,23,6,2,4,3,4,3,4,5,31,5,2,6,4,3,4,5,2,31,85,
Canada,2017,F,6,2,6,5,4,23,6,2,4,3,4,3,4,5,31,5,2,6,4,3,4,5,2,31,85,
Canada,2016,F,6,2,6,5,3,22,6,2,4,3,4,3,4,5,31,5,2,6,4,3,4,5,2,31,84,
Canada,2015,F,6,2,6,5,3,22,6,2,4,3,4,3,4,5,31,5,2,6,4,3,4,5,2,31,84,
Canada,2014,F,6,2,6,5,3,22,6,3,4,3,4,3,4,5,32,5,2,6,4,3,4,5,2,31,85,
China,2022,NF,5,1,1,1,0,8,0,0,0,0,0,0,1,1,2,0,0,0,0,0,0,0,0,0,10,
China,2021,NF,5,1,1,1,0,8,0,0,0,0,0,0,1,1,2,0,0,0,0,0,0,0,0,0,10,
China,2020,NF,5,1,1,1,0,8,0,0,0,0,0,0,1,1,2,0,0,0,0,0,0,0,0,0,10,
China,2019,NF,5,1,1,1,0,8,0,0,0,0,0,0,1,1,2,0,0,0,0,0,0,0,0,0,10,
China,2018,NF,5,1,1,1,0,8,0,0,0,1,0,0,1,2,4,0,0,0,0,0,0,0,0,0,12,
China,2017,NF,5,1,1,1,0,8,0,0,0,1,0,1,1,2,5,0,0,0,0,0,0,0,0,0,13,
China,2016,NF,4,1,1,1,0,7,0,0,0,1,0,1,1,2,5,0,0,0,0,0,0,0,0,0,12,
China,2015,NF,4,1,1,1,0,7,0,0,0,1,0,1,1,2,5,0,0,0,0,0,0,0,0,0,12,
China,2014,NF,3,1,1,1,0,6,0,0,0,1,0,1,1,3,6,0,0,1,0,0,0,0,0,1,13,
China,2013,NF,3,1,1,1,0,6,0,0,0,1,0,1,1,3,6,1,0,1,0,0,0,0,0,2,14,
China,2012,NF,4,1,1,1,0,7,0,0,0,1,0,1,1,3,6,1,0,1,0,0,0,0,0,2,15,
China,2011,NF,3,1,1,1,0,6,0,0,0,1,1,1,1,3,7,1,0,1,1,0,0,1,0,4,17,
Colombia,2022,PF,5,2,6,4,2,19,4,2,3,3,2,2,3,5,24,4,2,4,3,2,3,2,1,21,64,
Colombia,2021,PF,5,2,6,4,2,19,4,2,3,3,3,2,3,5,25,3,2,4,3,2,3,3,1,21,65,
Colombia,2020,PF,4,2,6,4,2,18,5,2,3,3,3,2,3,5,26,3,2,5,3,2,3,3,1,22,66,
Colombia,2019,PF,4,1,6,4,2,17,5,3,3,3,3,2,3,5,27,3,2,5,3,2,4,3,1,23,67,
Colombia,2018,PF,4,1,6,4,2,17,5,3,3,3,3,2,3,5,27,3,2,6,3,2,4,3,2,25,69,
Colombia,2017,PF,4,1,6,4,2,17,5,3,3,3,3,2,3,5,27,3,2,5,3,2,4,3,2,24,68,
Colombia,2016,PF,4,1,6,4,2,17,5,3,3,3,3,2,3,5,27,3,2,5,3,2,4,3,2,24,68,
Colombia,2015,PF,4,1,6,4,2,17,5,3,3,3,3,2,3,5,27,3,2,5,3,2,4,3,2,24,68,
Colombia,2014,F,4,1,6,4,2,17,5,3,3,3,3,2,3,5,27,3,3,6,3,2,4,3,2,26,70,
Costa Rica,2022,F,5,2,6,4,4,21,6,4,4,4,3,3,4,6,34,6,3,6,3,5,5,4,1,33,88,
Costa Rica,2021,F,4,2,6,4,4,20,6,3,4,4,3,3,4,6,33,6,3,6,3,5,5,4,2,34,87,
Cuba,2022,NF,3,0,1,0,0,4,2,1,0,1,1,0,1,3,9,0,0,2,1,1,0,2,1,7,20,
Cuba,2021,NF,3,0,2,0,0,5,2,1,0,1,1,0,1,3,9,0,0,2,1,1,0,2,1,7,21,
Cuba,2020,NF,2,0,3,0,0,5,3,1,0,1,1,0,1,3,10,0,0,2,1,1,0,2,1,7,22,
Cuba,2019,NF,2,0,3,0,0,5,3,1,0,1,1,0,1,3,10,0,0,2,1,1,0,2,1,7,22,
Cuba,2018,NF,2,0,3,0,0,5,3,1,0,1,1,0,1,2,9,0,0,2,1,1,0,2,1,7,21,
Cuba,2017,NF,1,0,3,0,0,4,3,1,0,1,1,0,1,2,9,0,0,2,1,1,0,2,2,8,21,
Cuba,2016,NF,1,0,3,0,0,4,3,1,0,1,1,0,1,2,9,0,0,2,1,1,0,2,2,8,21,
Cuba,2015,NF,0,0,3,0,0,3,3,1,0,1,0,0,1,2,8,0,0,2,1,1,0,2,2,8,19,
Cuba,2014,NF,0,0,2,0,0,2,3,1,0,1,0,0,1,1,7,0,0,2,1,1,0,1,2,7,16,
Cuba,2013,NF,0,0,1,0,0,1,3,1,0,1,0,0,0,1,6,0,0,2,1,1,0,1,2,7,14,
Cuba,2012,NF,0,0,1,0,0,1,3,1,0,1,0,0,0,1,6,0,0,2,1,1,0,1,2,7,14,
Cuba,2011,NF,0,0,1,0,0,1,3,1,0,0,0,0,0,1,5,0,0,2,1,1,0,1,2,7,13,
Ecuador,2022,PF,5,1,6,4,2,18,5,2,2,3,2,2,3,5,24,3,2,4,3,2,4,3,1,22,64,
Ecuador,2021,PF,4,1,6,4,2,17,6,2,2,3,2,2,3,5,25,3,2,3,3,2,4,2,1,20,62,
Ecuador,2020,PF,4,1,4,4,2,15,5,2,2,3,2,2,2,4,22,3,2,3,3,2,4,2,1,20,57,
Ecuador,2019,PF,4,1,6,4,1,16,6,2,2,3,2,2,2,5,24,3,2,3,3,2,4,3,1,21,61,
Ecuador,2018,PF,4,2,6,4,1,17,6,1,3,3,2,2,2,5,24,2,2,3,2,2,4,3,1,19,60,
Ecuador,2017,PF,4,2,6,4,1,17,6,1,3,2,1,2,2,5,22,2,2,3,2,2,4,2,1,18,57,
Ecuador,2016,PF,4,2,6,4,1,17,6,1,3,2,2,2,2,5,23,2,2,3,2,2,4,3,1,19,59,
Ecuador,2015,PF,4,2,6,4,1,17,6,1,3,2,2,2,3,5,24,3,2,4,2,3,4,2,2,22,63,
Ecuador,2014,PF,4,1,6,4,1,16,6,1,3,2,2,2,3,5,24,3,2,3,3,3,4,3,2,23,63,
Ecuador,2013,PF,3,1,6,4,1,15,6,2,3,2,2,2,3,4,24,3,3,3,3,4,4,2,2,24,63,
Egypt,2022,NF,4,1,4,3,1,13,1,1,1,1,1,0,2,3,10,0,0,0,1,1,0,1,1,4,27,
Egypt,2021,NF,4,1,3,3,1,12,1,1,1,1,1,0,2,3,10,0,0,0,1,1,0,1,1,4,26,
Egypt,2020,NF,3,1,3,3,1,11,1,1,1,1,1,0,2,3,10,0,0,1,1,1,0,1,1,5,26,
Egypt,2019,NF,3,1,2,3,1,10,1,1,1,1,1,0,2,4,11,0,0,1,1,1,0,1,1,5,26,
Egypt,2018,NF,2,1,2,3,1,9,2,1,1,1,1,1,2,5,14,0,0,1,1,1,0,1,1,5,28,
Egypt,2017,NF,2,1,2,3,1,9,3,2,2,1,1,1,2,5,17,1,0,0,1,1,0,2,1,6,32,
Egypt,2016,NF,2,1,3,3,1,10,4,2,3,1,1,1,3,5,20,1,0,1,2,1,0,1,1,7,37,
Egypt,2015,NF,2,1,4,3,1,11,6,2,3,1,1,1,3,5,22,1,0,0,2,1,0,1,1,6,39,
Egypt,2014,PF,2,1,3,3,1,10,6,2,3,2,1,1,3,5,23,1,0,2,2,1,0,0,1,7,40,
Egypt,2013,PF,2,1,3,3,1,10,6,2,3,2,1,1,3,5,23,1,0,2,2,1,0,0,1,7,40,
Egypt,2012,PF,2,1,4,3,1,11,6,2,2,2,2,1,3,5,23,1,0,2,2,1,0,0,1,7,41,
Egypt,2011,PF,2,1,5,4,1,13,4,3,2,2,2,1,3,4,21,2,0,2,3,1,1,1,2,12,46,
Estonia,2022,F,6,3,6,6,4,25,4,3,4,4,3,3,4,6,31,6,3,6,4,6,4,5,3,37,93,
Estonia,2021,F,6,3,6,6,4,25,5,3,4,4,3,3,4,6,32,6,3,6,4,6,4,5,3,37,94,
Estonia,2020,F,6,3,6,6,4,25,5,3,4,4,3,3,4,6,32,6,3,6,4,6,4,5,3,37,94,
Estonia,2019,F,6,3,6,6,4,25,5,3,4,4,3,3,4,6,32,6,3,6,4,6,4,5,3,37,94,
Estonia,2018,F,6,3,6,6,4,25,5,2,4,4,4,3,4,6,32,6,3,6,4,6,4,5,3,37,94,
Estonia,2017,F,6,3,6,6,4,25,5,3,4,3,4,3,4,6,32,6,3,6,4,6,4,5,3,37,94,
Estonia,2016,F,6,3,6,6,4,25,5,3,4,3,4,3,4,6,32,6,3,6,4,6,4,5,3,37,94,
Estonia,2015,F,6,3,6,6,3,24,5,3,4,3,4,3,4,6,32,6,3,6,4,6,4,5,3,37,93,
Estonia,2014,F,6,3,6,6,3,24,5,3,4,3,4,3,4,6,32,5,3,6,4,6,4,5,3,36,92,
Estonia,2013,F,6,3,6,6,3,24,5,3,4,3,4,3,4,6,32,5,3,6,4,6,4,5,2,35,91,
Estonia,2012,F,5,3,6,6,3,23,5,3,4,3,4,3,4,6,32,5,3,6,4,6,4,5,2,35,90,
Estonia,2011,F,5,3,6,6,3,23,5,3,4,4,4,3,4,6,33,5,3,6,4,6,3,5,2,34,90,
Ethiopia,2022,NF,1,1,1,1,1,5,4,2,0,1,1,1,2,2,13,1,0,2,2,1,1,1,1,9,27,
Ethiopia,2021,NF,1,1,0,1,1,4,3,2,0,1,1,1,2,2,12,1,0,3,2,1,1,2,1,11,27,
Ethiopia,2020,NF,1,1,1,1,1,5,3,2,0,1,1,1,2,2,12,1,0,3,2,1,1,3,1,12,29,
Ethiopia,2019,NF,1,0,1,1,0,3,3,2,0,1,1,1,2,2,12,1,0,4,2,1,1,3,1,13,28,
Ethiopia,2018,NF,1,0,0,1,0,2,2,1,0,1,1,1,0,0,6,0,0,2,2,1,1,2,1,9,17,
Ethiopia,2017,NF,0,0,0,1,0,1,2,1,0,0,1,1,0,0,5,0,0,1,2,1,1,2,1,8,14,
Ethiopia,2016,NF,0,0,1,1,0,2,2,1,0,1,1,1,0,1,7,1,0,1,2,1,1,1,1,8,17,
Ethiopia,2015,NF,0,0,1,1,0,2,2,1,0,1,1,1,0,1,7,1,0,1,2,1,1,2,1,9,18,
Ethiopia,2014,NF,0,0,1,1,0,2,2,1,0,1,1,1,0,1,7,1,0,2,2,1,1,3,1,11,20,
Ethiopia,2013,NF,0,0,2,1,0,3,2,1,0,1,1,1,0,1,7,1,0,2,2,1,1,3,1,11,21,
Ethiopia,2012,NF,0,0,2,1,0,3,2,2,0,1,1,1,0,1,8,1,1,2,2,2,1,3,2,14,25,
Ethiopia,2011,NF,0,0,3,1,0,4,3,3,0,1,1,1,0,0,9,1,1,5,2,2,1,4,2,18,31,
France,2022,F,6,3,6,4,4,23,4,2,3,4,3,3,4,6,29,5,2,5,2,2,3,3,2,24,76,
France,2021,F,6,3,6,4,4,23,5,2,3,4,3,3,4,6,30,5,2,5,2,2,3,4,2,25,78,
France,2020,F,6,3,6,4,4,23,5,2,3,4,3,3,4,6,30,4,2,5,2,2,3,4,2,24,77,
France,2019,F,6,3,6,3,4,22,5,2,3,4,3,3,4,6,30,4,2,5,2,2,3,4,2,24,76,
France,2018,F,6,3,6,3,4,22,5,2,2,4,4,3,4,5,29,4,2,5,2,2,3,4,2,24,75,
France,2017,F,6,3,6,3,4,22,5,2,2,4,3,3,4,5,28,4,2,5,2,2,3,4,2,24,74,
France,2016,F,6,3,6,3,4,22,5,2,2,4,4,3,4,5,29,4,2,5,2,2,3,4,2,24,75,
France,2015,F,6,3,6,3,4,22,5,2,2,4,4,3,4,5,29,5,2,4,2,2,3,5,2,25,76,
France,2014,F,6,3,6,3,4,22,5,3,3,4,4,3,4,5,31,5,3,5,2,2,3,5,2,27,80,
France,2013,F,6,3,5,3,4,21,5,3,3,4,4,3,4,5,31,5,3,5,3,3,3,4,2,28,80,
Gambia,2022,PF,2,1,4,4,1,12,6,2,2,3,2,2,3,4,24,3,1,4,2,2,1,4,3,20,56,
Georgia,2022,F,5,2,6,4,2,19,6,4,4,4,2,2,3,6,31,3,3,6,3,3,4,4,2,28,78,
Georgia,2021,F,5,2,6,4,2,19,6,4,4,4,2,2,3,6,31,3,3,6,3,3,4,4,1,27,77,
Georgia,2020,F,5,2,6,4,2,19,6,4,4,4,2,2,3,6,31,3,3,5,3,3,4,4,1,26,76,
Georgia,2019,F,5,2,6,4,2,19,6,3,3,4,3,2,3,6,30,3,3,4,3,3,4,4,2,26,75,
Georgia,2018,F,5,2,6,4,2,19,6,3,3,4,3,2,3,5,29,3,3,5,3,3,4,4,2,27,75,
Georgia,2017,F,5,2,5,4,2,18,6,3,3,4,3,2,3,5,29,3,3,6,3,3,4,5,2,29,76,
Georgia,2016,F,4,2,5,4,2,17,6,3,3,4,3,2,3,5,29,3,3,6,3,3,4,5,2,29,75,
Georgia,2015,F,4,2,6,4,2,18,6,3,3,4,3,2,3,5,29,3,3,6,3,3,4,5,2,29,76,
Georgia,2014,F,3,2,6,4,2,17,6,3,3,4,3,2,3,4,28,3,3,6,3,3,4,5,2,29,74,
Georgia,2013,F,3,2,6,4,2,17,6,3,3,4,3,2,3,4,28,3,3,6,3,3,4,5,2,29,74,
Georgia,2012,F,3,2,5,4,2,16,5,3,3,3,2,2,3,4,25,3,3,6,3,3,4,5,2,29,70,
Georgia,2011,PF,2,2,5,2,2,13,5,4,3,3,2,2,3,3,25,3,2,5,3,4,4,4,2,27,65,
Germany,2022,F,6,3,6,5,3,23,4,2,3,4,3,2,4,6,28,5,2,5,3,2,3,4,2,26,77,
Germany,2021,F,6,2,6,5,3,22,5,2,3,4,3,2,4,6,29,5,3,5,3,2,4,4,2,28,79,
Germany,2020,F,6,2,6,5,3,22,5,2,3,4,4,2,4,6,30,5,3,5,3,2,4,4,2,28,80,
Germany,2019,F,6,2,6,5,3,22,5,2,3,4,4,2,4,6,30,5,3,5,3,2,4,4,2,28,80,
Germany,2018,F,6,2,6,5,3,22,5,2,3,4,4,2,4,6,30,5,3,5,3,2,4,5,2,29,81,
Germany,2017,F,6,2,6,5,3,22,5,2,3,4,3,2,4,6,29,5,3,5,3,2,4,5,2,29,80,
Germany,2016,F,6,2,6,5,3,22,5,2,3,4,4,2,4,6,30,5,3,5,3,2,4,5,2,29,81,
Germany,2015,F,6,2,6,4,3,21,5,2,3,4,4,2,4,6,30,5,4,6,3,2,4,5,2,31,82,
Germany,2014,F,5,2,6,5,3,21,5,2,3,4,4,3,4,6,31,5,4,6,3,2,4,5,2,31,83,
Germany,2013,F,5,2,6,5,3,21,5,2,3,4,4,3,4,6,31,5,4,6,3,2,4,5,2,31,83,
Germany,2012,F,6,2,6,4,3,21,5,3,3,4,4,3,4,6,32,5,3,6,4,3,4,5,2,32,85,
Germany,2011,F,5,2,6,4,4,21,5,2,3,4,4,3,4,5,30,5,3,6,4,4,4,5,2,33,84,
Ghana,2022,PF,3,1,5,4,1,14,6,3,2,3,2,3,3,5,27,4,2,3,2,3,3,3,3,23,64,
Ghana,2021,PF,3,1,5,4,1,14,6,3,2,3,2,3,3,5,27,4,2,3,2,3,3,3,3,23,64,
Hungary,2022,PF,6,3,6,5,2,22,4,2,3,3,2,1,3,6,24,4,2,4,2,2,4,4,1,23,69,
Hungary,2021,F,6,2,6,5,2,21,5,2,3,3,2,1,3,5,24,4,2,4,2,2,4,4,3,25,70,
Hungary,2020,F,6,2,6,5,2,21,5,2,3,3,2,1,3,5,24,4,2,4,2,3,4,4,3,26,71,
Hungary,2019,F,6,2,6,5,2,21,5,2,3,3,2,1,3,5,24,4,2,4,2,3,4,5,3,27,72,
Hungary,2018,F,6,2,6,5,2,21,5,2,3,3,2,1,3,5,24,4,2,4,2,3,4,4,3,26,71,
Hungary,2017,F,6,2,6,5,2,21,5,2,3,3,2,1,3,5,24,4,2,4,2,3,4,4,3,26,71,
Hungary,2016,F,5,2,6,5,2,20,5,2,3,3,3,1,3,5,25,4,2,4,3,3,4,5,3,28,73,
Hungary,2015,F,6,2,6,5,2,21,5,2,3,3,3,2,3,5,26,4,2,5,3,4,4,4,3,29,76,
Hungary,2014,F,5,2,6,5,2,20,6,2,3,3,3,2,3,5,27,4,2,5,3,4,4,4,3,29,76,
Hungary,2013,F,5,2,6,5,2,20,6,2,3,3,3,2,3,5,27,4,3,5,3,4,4,4,3,30,77,
Hungary,2012,F,5,2,6,5,2,20,6,3,3,3,3,3,3,5,29,4,3,6,3,4,4,5,3,32,81,
Iceland,2022,F,6,3,6,6,4,25,5,4,4,4,4,3,4,6,34,6,3,6,4,6,4,5,2,36,95,
Iceland,2021,F,6,3,6,6,4,25,5,4,4,4,4,3,4,6,34,6,3,6,4,6,4,5,3,37,96,
Iceland,2020,F,6,3,6,6,4,25,5,4,4,4,4,3,4,6,34,6,3,6,4,6,4,5,2,36,95,
Iceland,2019,F,6,3,6,6,4,25,5,4,4,4,4,3,4,6,34,6,3,6,4,6,4,5,2,36,95,
Iceland,2018,F,6,3,6,6,4,25,5,4,4,4,4,3,4,6,34,6,3,5,4,6,4,5,2,35,94,
Iceland,2017,F,6,3,6,6,3,24,6,4,4,4,3,3,4,6,34,6,3,5,4,6,4,5,3,36,94,
Iceland,2016,F,6,3,6,6,3,24,6,4,4,4,3,3,4,6,34,6,3,5,4,6,4,5,3,36,94,
Iceland,2015,F,6,3,6,6,3,24,6,4,4,4,3,3,4,6,34,6,3,5,4,6,4,5,3,36,94,
Iceland,2014,F,6,3,6,6,3,24,6,4,4,4,3,3,4,6,34,6,3,5,4,6,4,5,3,36,94,
Iceland,2013,F,6,3,6,6,3,24,6,4,4,4,3,3,4,6,34,6,3,5,4,6,4,5,3,36,94,
India,2022,PF,3,2,2,4,2,13,3,2,2,3,2,2,3,4,21,4,2,2,2,1,2,2,2,17,51,
India,2021,PF,3,1,1,4,2,11,3,2,2,3,2,2,3,4,21,4,2,2,2,1,2,2,2,17,49,
India,2020,PF,3,1,2,4,2,12,3,2,2,3,2,2,3,4,21,4,2,2,3,1,2,2,2,18,51,
India,2019,PF,3,1,2,4,2,12,3,3,2,3,2,3,3,5,24,4,2,2,3,2,2,2,2,19,55,
India,2018,PF,3,1,2,4,2,12,3,3,2,3,2,3,3,6,25,4,2,3,3,2,2,2,2,20,57,
India,2017,PF,3,1,3,4,2,13,3,3,2,3,3,3,3,6,26,4,2,3,3,2,2,2,2,20,59,
India,2016,PF,2,1,4,4,2,13,3,3,2,3,3,3,3,6,26,4,2,3,3,2,2,2,2,20,59,
India,2015,PF,2,1,4,4,2,13,3,3,2,3,3,3,3,5,25,4,2,4,3,2,2,3,2,22,60,
India,2014,PF,1,1,4,4,2,12,4,2,2,3,3,3,3,5,25,3,2,3,3,2,2,4,2,21,58,
India,2013,PF,1,1,3,4,1,10,3,1,2,3,3,3,3,5,23,3,2,3,3,2,2,3,2,20,53,
India,2012,PF,1,1,4,4,2,12,4,2,2,3,4,3,3,5,26,3,2,4,3,3,2,4,2,23,61,
India,2011,PF,1,1,5,4,2,13,5,3,3,3,4,2,3,4,27,4,2,4,2,3,3,4,2,24,64,
Indonesia,2022,PF,3,1,4,4,2,14,3,2,1,2,1,1,3,4,17,2,1,2,3,2,4,3,1,18,49,
Indonesia,2021,PF,3,1,4,4,2,14,3,2,1,2,1,1,3,4,17,2,1,2,3,2,4,2,1,17,48,
Indonesia,2020,PF,4,1,3,4,2,14,3,2,1,2,1,2,3,4,18,2,1,2,3,2,4,2,1,17,49,
Indonesia,2019,PF,4,1,3,4,2,14,3,2,1,2,2,2,3,4,19,2,1,2,3,2,4,2,2,18,51,
Indonesia,2018,PF,4,1,4,4,2,15,3,2,1,2,3,2,3,4,20,2,1,2,3,2,4,3,2,19,54,
Indonesia,2017,PF,4,1,4,4,2,15,3,2,1,2,3,2,3,4,20,2,1,2,3,2,4,2,2,18,53,
Indonesia,2016,PF,3,1,4,4,2,14,4,2,1,2,3,2,3,4,21,2,1,3,3,2,4,4,2,21,56,
Indonesia,2015,PF,2,1,5,4,2,14,4,3,2,2,3,2,3,4,23,2,1,3,3,2,4,4,2,21,58,
Indonesia,2014,PF,2,1,5,4,2,14,4,3,2,2,3,2,3,4,23,2,1,3,3,2,4,4,2,21,58,
Indonesia,2013,PF,2,1,5,4,2,14,5,3,2,2,3,2,3,4,24,2,1,3,3,3,4,3,2,21,59,
Indonesia,2012,PF,2,1,5,4,2,14,5,3,2,2,3,2,3,4,24,2,1,3,3,3,4,2,2,20,58,
Indonesia,2011,PF,1,1,4,3,2,11,5,3,1,2,3,2,3,3,22,2,1,3,3,3,4,3,2,21,54,
Iran,2022,NF,5,1,1,0,0,7,0,0,0,1,1,0,1,2,5,0,0,1,1,1,0,1,0,4,16,
Iran,2021,NF,5,1,2,0,0,8,0,0,0,1,1,0,1,2,5,0,0,0,1,1,0,1,0,3,16,
Iran,2020,NF,5,1,1,0,0,7,0,0,0,1,1,0,1,2,5,0,0,0,1,1,0,1,0,3,15,
Iran,2019,NF,4,1,2,0,0,7,0,0,0,1,1,0,1,2,5,0,0,0,1,1,0,1,0,3,15,
Iran,2018,NF,4,1,1,0,0,6,0,0,0,1,1,0,1,2,5,0,0,1,1,1,0,1,0,4,15,
Iran,2017,NF,4,1,2,0,0,7,0,0,0,1,1,0,1,2,5,0,0,0,1,1,0,1,0,3,15,
Iran,2016,NF,3,1,2,0,0,6,0,0,0,1,1,0,1,1,4,0,0,0,1,1,0,1,0,3,13,
Iran,2015,NF,2,1,2,0,0,5,0,0,0,1,1,0,1,1,4,0,0,1,1,1,0,1,0,4,13,
Iran,2014,NF,1,1,1,0,0,3,0,0,0,1,1,0,1,1,4,0,0,1,1,1,0,1,0,4,11,
Iran,2013,NF,1,1,1,0,0,3,0,0,0,0,1,0,1,1,3,0,0,1,1,1,0,0,0,3,9,
Iran,2012,NF,2,1,1,0,0,4,0,1,0,0,0,0,1,1,3,0,0,0,1,0,0,1,1,3,10,
Iran,2011,NF,2,1,0,1,0,4,1,1,1,1,0,0,1,1,6,0,0,1,0,0,0,0,0,1,11,
Iraq,2022,PF,3,1,4,3,1,12,5,1,1,1,1,2,2,3,16,2,1,1,3,3,3,0,1,14,42,
Iraq,2021,PF,3,1,3,3,1,11,5,1,1,1,1,2,2,3,16,2,1,1,3,3,3,0,1,14,41,
Italy,2022,F,5,2,6,5,3,21,4,3,3,3,3,3,4,6,29,4,2,5,3,3,3,3,2,25,75,
Italy,2021,F,5,2,6,5,3,21,5,3,3,3,3,3,4,6,30,4,2,5,3,3,3,3,2,25,76,
Italy,2020,F,5,2,6,5,3,21,5,3,3,3,3,3,4,6,30,4,2,5,3,3,3,3,2,25,76,
Italy,2019,F,5,2,6,5,3,21,5,3,3,3,3,3,4,6,30,4,2,5,3,3,3,3,1,24,75,
Italy,2018,F,5,2,5,6,3,21,5,3,3,3,3,3,4,5,29,4,2,5,3,3,3,3,2,25,75,
Italy,2017,F,5,2,5,6,3,21,5,3,3,3,3,3,4,5,29,4,2,5,3,3,3,3,2,25,75,
Italy,2016,F,5,2,5,6,3,21,5,3,3,3,3,3,4,5,29,4,2,5,3,3,3,3,2,25,75,
Italy,2015,F,5,2,5,6,3,21,5,3,3,3,3,3,4,5,29,4,2,5,3,3,3,5,2,27,77,
Italy,2014,F,5,2,5,6,3,21,5,3,3,3,3,3,4,5,29,4,2,5,3,4,3,5,2,28,78,
Italy,2013,F,4,2,5,6,3,20,5,3,3,3,3,3,4,5,29,4,2,5,3,4,3,5,2,28,77,
Italy,2012,F,5,2,5,6,3,21,5,3,3,3,3,2,4,5,28,4,2,5,3,4,3,5,2,28,77,
Italy,2011,F,4,2,5,5,3,19,5,3,3,3,3,2,4,4,27,4,2,5,3,4,3,5,2,28,74,
Japan,2022,F,6,3,6,5,2,22,6,3,3,3,2,2,4,6,29,5,2,5,3,2,3,4,2,26,77,
Japan,2021,F,6,2,6,5,2,21,6,3,3,3,2,2,4,6,29,5,2,5,3,2,3,4,2,26,76,
Japan,2020,F,6,2,6,5,2,21,5,3,3,3,2,2,4,6,28,5,2,5,3,2,3,4,2,26,75,
Japan,2019,F,6,2,6,5,2,21,5,3,3,3,2,2,4,6,28,5,2,5,3,2,3,2,2,24,73,
Japan,2018,F,6,2,6,5,2,21,5,3,3,3,2,2,4,5,27,5,2,4,3,3,3,5,2,27,75,
Japan,2017,F,6,2,6,5,2,21,6,3,3,3,2,2,4,5,28,5,2,5,3,3,3,5,2,28,77,
Japan,2016,F,6,2,6,5,2,21,6,3,3,3,2,2,4,5,28,5,2,4,3,5,3,5,2,29,78,
Japan,2015,F,6,2,6,5,2,21,6,3,3,3,2,2,4,5,28,5,2,4,3,5,3,5,2,29,78,
Japan,2014,F,6,2,6,5,2,21,6,3,3,3,2,2,4,5,28,5,2,4,3,5,3,5,2,29,78,
Japan,2013,F,6,2,6,5,2,21,6,3,3,3,2,2,4,5,28,5,2,4,3,5,3,5,2,29,78,
Jordan,2022,PF,5,1,4,3,1,14,3,1,1,2,2,1,3,4,17,2,1,3,2,2,2,3,1,16,47,
Jordan,2021,PF,5,1,3,3,1,13,3,1,1,2,2,1,3,4,17,2,1,3,2,3,2,3,1,17,47,
Jordan,2020,PF,5,1,4,3,1,14,4,1,1,2,2,1,3,5,19,2,1,2,2,3,2,3,1,16,49,
Jordan,2019,PF,5,1,4,3,1,14,3,1,1,2,2,1,3,5,18,2,1,2,2,3,2,2,1,15,47,
Jordan,2018,PF,5,1,4,3,1,14,4,1,2,2,1,1,3,6,20,2,1,3,2,3,3,2,1,17,51,
Jordan,2017,PF,4,1,3,3,1,12,3,1,2,2,1,1,3,5,18,2,1,3,2,3,3,1,2,17,47,
Jordan,2016,PF,4,1,3,3,1,12,4,1,2,2,1,1,3,5,19,2,1,2,2,3,3,3,2,18,49,
Jordan,2015,PF,4,1,4,3,1,13,4,1,2,2,1,1,3,5,19,2,1,2,2,3,3,3,2,18,50,
Jordan,2014,PF,4,1,4,3,1,13,3,1,3,2,2,1,3,5,20,2,1,3,2,3,3,3,2,19,52,
Jordan,2013,PF,3,1,4,3,1,12,5,1,3,2,2,1,3,5,22,2,1,5,2,3,3,2,2,20,54,
Jordan,2012,PF,3,1,4,3,1,12,5,2,3,2,2,2,3,4,23,3,1,3,3,3,3,2,2,20,55,
Jordan,2011,PF,3,1,4,4,1,13,5,4,3,2,2,2,3,3,24,3,2,2,3,3,2,4,2,21,58,
Kazakhstan,2022,NF,5,2,1,2,0,10,2,1,1,1,1,1,2,2,11,1,0,2,1,2,2,2,1,11,32,
Kazakhstan,2021,NF,5,2,2,2,0,11,2,1,1,1,1,1,2,2,11,1,0,2,1,2,2,2,1,11,33,
Kazakhstan,2020,NF,5,2,1,2,0,10,2,1,1,1,1,1,2,2,11,1,0,2,1,2,2,2,1,11,32,
Kazakhstan,2019,NF,5,2,1,2,0,10,2,1,1,1,1,1,2,2,11,1,0,2,1,2,2,2,1,11,32,
Kazakhstan,2018,NF,6,2,2,3,0,13,2,1,1,1,1,1,2,2,11,1,0,2,1,2,3,4,1,14,38,
Kazakhstan,2017,NF,6,2,1,3,0,12,2,1,1,1,1,1,2,3,12,1,0,2,1,2,3,4,1,14,38,
Kazakhstan,2016,NF,5,2,1,3,0,11,2,1,1,1,1,1,2,3,12,1,0,2,1,2,3,3,2,14,37,
Kazakhstan,2015,NF,5,2,1,3,0,11,2,1,1,1,1,1,2,3,12,1,0,3,2,2,2,4,2,16,39,
Kazakhstan,2014,PF,4,2,2,2,0,10,2,1,1,1,1,1,2,3,12,1,1,3,3,2,2,4,2,18,40,
Kazakhstan,2013,PF,4,2,2,2,0,10,2,1,1,1,1,1,2,3,12,1,1,4,3,3,2,3,2,19,41,
Kazakhstan,2012,PF,4,2,1,3,0,10,3,1,1,1,1,1,2,2,12,1,1,5,3,3,2,3,2,20,42,
Kazakhstan,2011,PF,3,1,2,3,0,9,3,2,1,1,1,1,2,2,13,1,1,6,4,3,2,4,2,23,45,
Kenya,2022,PF,3,1,6,4,2,16,6,2,3,3,2,2,3,6,27,4,2,4,3,2,4,3,3,25,68,
Kenya,2021,PF,3,1,6,4,2,16,6,2,3,3,2,2,3,6,27,4,2,3,3,2,4,3,2,23,66,
Kenya,2020,PF,4,1,6,4,2,17,6,2,3,3,3,2,3,6,28,3,2,3,3,2,4,3,2,22,67,
Kenya,2019,PF,4,1,6,4,2,17,6,2,3,3,3,2,3,6,28,4,2,3,3,2,4,3,2,23,68,
Kenya,2018,PF,5,1,6,4,2,18,6,2,3,3,2,3,3,5,27,4,2,3,3,2,4,3,2,23,68,
Kenya,2017,F,5,1,6,4,2,18,6,2,3,3,3,3,3,5,28,4,3,3,3,2,4,3,3,25,71,
Kenya,2016,F,4,1,6,4,2,17,6,2,3,3,3,3,3,5,28,4,2,3,3,4,4,3,3,26,71,
Kenya,2015,F,3,1,6,4,2,16,5,2,3,3,4,3,3,5,28,4,2,3,3,4,4,4,3,27,71,
Kenya,2014,F,3,1,6,4,2,16,5,3,3,3,4,2,3,5,28,4,2,4,3,4,4,4,3,28,72,
Kenya,2013,F,3,1,6,4,2,16,5,3,3,3,4,2,3,5,28,4,2,4,3,4,4,4,3,28,72,
Kenya,2012,F,2,1,6,4,2,15,6,3,3,3,4,2,3,4,28,3,2,5,3,4,4,4,3,28,71,
Kenya,2011,PF,1,1,6,4,1,13,6,3,3,2,3,2,3,4,26,3,2,6,3,4,4,4,3,29,68,
Kyrgyzstan,2022,PF,4,2,5,3,1,15,4,2,1,3,2,2,3,5,22,2,2,2,2,2,2,3,1,16,53,
Kyrgyzstan,2021,PF,3,2,4,3,1,13,4,2,2,3,2,2,3,5,23,2,2,2,3,2,2,3,1,17,53,
Kyrgyzstan,2020,PF,3,2,4,4,1,14,4,2,2,3,3,2,3,5,24,3,2,2,3,2,2,3,1,18,56,
Kyrgyzstan,2019,PF,3,2,5,4,1,15,4,2,2,3,3,2,3,6,25,3,2,3,3,2,2,4,2,21,61,
Kyrgyzstan,2018,PF,3,2,5,4,1,15,4,2,2,3,3,3,3,5,25,3,2,3,3,2,2,4,3,22,62,
Kyrgyzstan,2017,PF,3,2,5,4,1,15,5,2,2,3,3,3,3,5,26,3,2,3,3,2,2,4,3,22,63,
Kyrgyzstan,2016,PF,3,2,5,4,1,15,5,4,2,3,3,3,3,5,28,3,2,3,3,2,2,4,3,22,65,
Kyrgyzstan,2015,PF,3,1,5,4,1,14,4,4,2,3,3,3,3,5,27,3,2,4,3,3,2,4,3,24,65,
Kyrgyzstan,2014,PF,3,1,4,4,1,13,4,3,2,3,3,3,3,5,26,3,2,6,3,3,4,3,3,27,66,
Kyrgyzstan,2013,PF,3,1,4,4,1,13,4,2,2,3,3,3,3,5,25,3,2,5,4,3,4,3,3,27,65,
Kyrgyzstan,2012,PF,2,1,4,4,1,12,4,3,2,3,3,3,3,4,25,3,2,5,4,3,4,4,3,28,65,
Lebanon,2022,PF,4,1,4,1,1,11,4,2,2,2,2,2,3,5,22,2,2,3,3,2,2,2,2,18,51,
Lebanon,2021,PF,4,1,4,1,1,11,4,2,2,2,2,2,3,5,22,2,2,3,3,2,2,2,2,18,51,
Lebanon,2020,PF,4,1,4,2,1,12,4,2,2,2,2,2,3,5,22,2,2,3,3,2,2,2,2,18,52,
Lebanon,2019,PF,4,1,4,2,1,12,4,2,2,2,2,2,3,6,23,2,2,2,3,2,3,2,1,17,52,
Lebanon,2018,PF,4,1,3,3,1,12,4,2,2,2,2,2,3,6,23,2,2,2,4,2,3,2,1,18,53,
Lebanon,2017,PF,4,1,2,3,1,11,4,2,2,2,2,2,3,6,23,2,2,3,4,2,3,3,1,20,54,
Lebanon,2016,PF,4,1,3,3,1,12,4,2,2,2,2,2,3,6,23,2,2,3,4,2,3,3,1,20,55,
Lebanon,2015,PF,4,1,3,3,1,12,4,2,2,2,2,2,3,6,23,2,2,3,4,2,3,3,1,20,55,
Lebanon,2014,PF,3,1,3,3,1,11,4,2,2,2,2,2,3,6,23,2,2,3,3,3,3,2,1,19,53,
Lebanon,2013,PF,3,1,3,3,1,11,5,2,3,2,2,2,4,5,25,2,2,3,3,3,3,2,1,19,55,
Libya,2022,PF,2,1,4,1,0,8,6,3,2,1,1,3,2,3,21,1,1,2,3,2,3,1,2,15,44,
Libya,2021,PF,2,1,3,1,0,7,6,3,3,1,2,3,3,4,25,1,1,3,3,2,3,1,2,16,48,
Libya,2020,PF,2,1,4,1,0,8,6,3,3,1,2,3,3,4,25,1,1,3,3,2,3,2,2,17,50,
Libya,2019,PF,2,1,4,1,0,8,5,3,3,1,2,3,3,4,24,1,1,3,3,2,3,2,2,17,49,
Libya,2018,PF,2,1,4,1,0,8,5,3,3,1,2,3,3,4,24,1,1,3,3,2,3,2,2,17,49,
Libya,2017,PF,1,1,2,1,0,5,5,3,3,1,2,3,3,3,23,1,1,5,3,2,2,2,2,18,46,
Libya,2016,PF,1,1,2,1,0,5,4,3,2,1,2,3,3,4,22,1,1,3,3,2,2,1,2,15,42,
Libya,2015,PF,1,1,2,1,0,5,4,3,2,1,3,3,3,4,23,1,1,6,3,2,2,1,2,18,46,
Libya,2014,PF,1,2,2,1,1,7,4,3,3,2,4,3,3,4,26,2,1,5,3,2,2,2,2,19,52,
Libya,2013,PF,1,2,3,1,1,8,4,3,3,2,4,3,3,4,26,2,1,5,3,2,2,3,3,21,55,
Libya,2012,PF,1,2,2,1,1,7,6,3,3,2,3,2,3,4,26,2,1,5,3,3,4,3,3,24,57,
Malawi,2022,PF,1,1,5,3,1,11,6,3,3,3,2,1,2,5,25,3,1,3,3,4,2,4,1,21,57,
Malawi,2021,PF,1,1,5,3,1,11,6,3,3,3,2,1,2,5,25,3,1,3,3,4,2,4,3,23,59,
Malawi,2020,PF,1,1,5,3,1,11,6,3,3,3,2,1,2,5,25,3,1,4,3,4,2,4,3,24,60,
Malawi,2019,PF,0,1,4,3,1,9,6,3,3,3,2,1,2,5,25,3,1,3,3,4,2,4,3,23,57,
Malawi,2018,PF,0,1,4,3,1,9,6,3,3,3,2,1,3,4,25,3,1,6,4,4,2,4,3,27,61,
Malawi,2017,PF,0,1,4,3,1,9,6,2,3,3,2,1,3,4,24,3,1,3,4,4,2,5,3,25,58,
Malawi,2016,PF,0,1,4,3,1,9,6,2,3,3,3,1,3,4,25,3,2,3,4,4,2,4,3,25,59,
Malawi,2015,PF,1,1,4,3,1,10,5,2,3,2,3,1,3,4,23,3,2,5,4,4,2,4,3,27,60,
Malawi,2014,PF,0,1,4,3,1,9,6,3,3,2,2,1,3,4,24,3,2,3,4,4,2,4,3,25,58,
Malawi,2013,PF,0,1,4,3,1,9,6,3,3,2,2,1,3,4,24,3,2,3,4,4,2,4,3,25,58,
Malaysia,2022,PF,5,3,5,4,1,18,4,2,2,2,2,2,3,5,22,2,1,2,3,2,4,3,2,19,59,
Malaysia,2021,PF,5,3,5,4,1,18,4,2,2,2,2,1,3,5,21,2,1,2,3,2,4,3,2,19,58,
Malaysia,2020,PF,5,3,4,4,1,17,4,2,2,2,2,1,3,5,21,2,1,2,3,2,4,4,2,20,58,
Malaysia,2019,PF,5,3,4,4,1,17,4,2,2,2,2,1,3,5,21,2,1,2,3,2,4,3,2,19,57,
Malaysia,2018,PF,6,2,4,4,1,17,3,2,2,2,1,1,3,5,19,2,1,2,3,2,4,4,1,19,55,
Malaysia,2017,PF,6,2,4,4,1,17,3,2,2,2,1,1,3,5,19,3,1,2,3,2,4,3,2,20,56,
Malaysia,2016,PF,5,2,4,4,1,16,3,2,2,2,1,1,3,5,19,3,1,2,3,2,4,3,2,20,55,
Malaysia,2015,PF,5,2,5,4,1,17,4,2,2,2,1,2,3,5,21,3,1,2,3,2,4,3,1,19,57,
Malaysia,2014,PF,5,2,5,4,1,17,4,2,2,2,1,2,3,5,21,3,1,3,3,2,4,3,1,20,58,
Malaysia,2013,PF,5,2,5,3,1,16,4,2,2,2,1,2,3,4,20,3,1,3,3,2,4,4,0,20,56,
Malaysia,2012,PF,4,2,5,3,1,15,5,2,2,2,1,2,3,4,21,3,1,3,3,2,4,4,1,21,57,
Malaysia,2011,PF,4,2,5,4,1,16,6,3,2,2,2,2,3,4,24,3,1,2,3,2,4,3,1,19,59,
Mexico,2022,PF,5,1,6,4,2,18,6,2,3,2,1,2,3,6,25,3,2,4,3,1,4,0,1,18,61,
Mexico,2021,PF,5,1,6,4,2,18,6,2,3,2,1,2,3,6,25,3,2,4,2,1,4,0,1,17,60,
Mexico,2020,PF,4,1,6,4,2,17,6,3,3,2,1,2,3,6,26,3,2,4,3,1,4,0,1,18,61,
Mexico,2019,PF,4,1,6,4,2,17,6,3,3,1,1,2,3,6,25,3,2,4,4,1,4,0,0,18,60,
Mexico,2018,PF,5,1,6,4,2,18,6,3,3,1,1,2,2,6,24,3,2,4,4,1,4,0,0,18,60,
Mexico,2017,PF,5,1,6,4,2,18,6,3,3,1,2,2,2,6,25,3,2,4,4,1,4,0,0,18,61,
Mexico,2016,PF,4,1,6,4,2,17,6,3,3,1,2,2,2,6,25,3,2,4,4,2,4,0,1,20,62,
Mexico,2015,PF,3,1,6,4,2,16,6,3,3,1,2,2,2,6,25,3,2,4,4,2,4,0,1,20,61,
Mexico,2014,PF,3,1,6,4,1,15,6,3,3,1,2,2,2,6,25,3,2,4,4,2,4,1,1,21,61,
Mexico,2013,PF,3,1,6,3,1,14,6,3,3,2,2,2,2,5,25,3,2,4,4,3,4,1,2,23,62,
Mexico,2012,PF,3,1,6,3,1,14,6,3,3,2,3,2,2,3,24,3,2,5,4,3,5,1,2,25,63,
Mexico,2011,PF,2,1,6,3,1,13,6,3,2,3,3,2,3,3,25,3,2,6,3,4,5,4,3,30,68,
Morocco,2022,PF,4,2,4,4,1,15,6,2,2,2,2,1,2,4,21,2,1,2,3,1,2,3,1,15,51,
Morocco,2021,PF,5,1,4,4,1,15,6,2,2,2,2,1,2,5,22,2,1,3,3,1,2,3,1,16,53,
Morocco,2020,PF,4,1,4,4,1,14,6,2,2,2,2,1,3,5,23,2,1,2,3,1,2,3,1,15,52,
Morocco,2019,PF,4,1,4,4,1,14,6,2,2,2,2,1,3,6,24,2,1,2,3,2,2,3,1,16,54,
Morocco,2018,PF,4,1,4,4,1,14,6,2,3,2,2,1,3,6,25,2,1,2,3,2,2,3,1,16,55,
Morocco,2017,PF,4,1,4,4,1,14,6,2,3,2,2,1,3,6,25,2,1,2,3,2,2,3,1,16,55,
Morocco,2016,PF,4,1,3,4,1,13,6,2,3,2,2,2,3,6,26,2,1,2,4,2,2,3,1,17,56,
Morocco,2015,PF,4,1,4,4,1,14,6,2,3,2,2,2,3,6,26,2,1,2,4,2,2,3,1,17,57,
Morocco,2014,PF,4,1,4,4,1,14,4,2,3,2,3,2,3,6,25,2,1,2,4,2,2,3,1,17,56,
Morocco,2013,PF,4,1,4,4,1,14,6,2,4,2,3,2,3,6,28,2,1,2,4,2,2,2,1,16,58,
Myanmar,2022,NF,2,0,0,0,0,2,1,1,0,1,1,0,1,1,6,0,0,0,2,1,0,0,1,4,12,
Myanmar,2021,NF,2,1,0,1,0,4,1,1,0,1,1,0,1,2,7,0,0,1,2,1,1,0,1,6,17,
Myanmar,2020,NF,2,1,1,2,1,7,3,1,1,1,1,1,1,4,13,1,0,1,3,2,1,2,1,11,31,
Myanmar,2019,NF,2,1,4,2,1,10,6,1,1,1,1,1,1,4,16,1,0,1,3,2,1,1,1,10,36,
Myanmar,2018,NF,2,1,4,2,1,10,6,1,1,1,1,1,1,4,16,1,0,1,3,2,1,1,1,10,36,
Myanmar,2017,NF,1,1,4,1,1,8,6,1,2,1,1,1,2,4,18,1,0,1,3,2,1,2,1,11,37,
Myanmar,2016,NF,1,1,4,1,1,8,6,1,2,1,1,1,2,4,18,1,0,2,3,2,1,3,1,13,39,
Myanmar,2015,NF,0,1,4,1,1,7,6,1,2,1,1,1,2,4,18,1,0,2,3,2,1,2,1,12,37,
Myanmar,2014,PF,0,0,4,1,1,6,6,2,2,1,1,1,2,4,19,1,0,3,3,2,1,3,2,15,40,
Myanmar,2013,NF,0,0,3,1,1,5,6,2,2,1,1,1,2,4,19,1,0,4,2,2,1,3,1,14,38,
Myanmar,2012,NF,0,0,2,1,0,3,3,2,0,2,1,0,2,2,12,0,0,2,2,1,0,3,2,10,25,
Myanmar,2011,NF,0,0,1,1,0,2,2,1,0,1,0,0,1,1,6,0,0,0,1,1,0,1,1,4,12,
Nicaragua,2022,PF,3,0,5,3,0,11,6,1,1,1,1,1,2,4,17,2,1,2,4,2,3,2,1,17,45,
Nicaragua,2021,PF,3,0,5,4,0,12,6,1,1,2,1,1,2,4,18,2,1,3,4,2,3,2,1,18,48,
Nigeria,2022,PF,2,1,6,5,2,16,3,3,2,3,2,3,3,5,24,3,1,1,2,3,3,2,2,17,57,
Nigeria,2021,PF,3,1,6,5,2,17,4,3,2,3,2,3,3,5,25,3,1,2,2,3,3,2,1,17,59,
Nigeria,2020,PF,2,1,6,5,2,16,4,3,2,3,2,3,3,6,26,3,1,2,3,3,3,2,1,18,60,
Nigeria,2019,PF,3,1,6,5,2,17,3,4,2,3,2,3,3,6,26,3,1,2,3,3,4,2,3,21,64,
Nigeria,2018,PF,3,1,6,4,2,16,3,3,2,3,3,2,3,6,25,3,1,3,3,3,4,2,3,22,63,
Nigeria,2017,PF,3,1,6,4,2,16,6,3,3,3,3,2,3,5,28,3,1,3,3,3,4,3,2,22,66,
Nigeria,2016,PF,3,1,5,4,2,15,6,3,3,3,3,2,3,5,28,3,1,3,3,3,4,4,2,23,66,
Nigeria,2015,PF,3,1,5,4,2,15,6,3,3,3,3,1,3,5,27,3,2,4,3,3,4,4,2,25,67,
Nigeria,2014,PF,3,1,5,4,2,15,6,3,3,3,3,1,3,5,27,3,2,4,3,3,4,4,2,25,67,
Nigeria,2013,PF,2,1,6,4,2,15,6,3,3,3,3,1,3,5,27,3,3,5,3,3,4,4,2,27,69,
Nigeria,2012,PF,1,1,6,3,2,13,6,3,3,2,3,2,3,4,26,3,3,5,3,4,4,4,2,28,67,
Nigeria,2011,PF,1,1,6,2,2,12,6,3,3,2,3,2,3,3,25,3,3,5,3,4,4,4,2,28,65,
Pakistan,2022,NF,1,0,2,3,0,6,1,1,1,1,2,2,2,3,13,2,0,1,1,1,1,1,0,7,26,
Pakistan,2021,NF,1,0,1,3,0,5,1,1,1,1,2,2,2,3,13,2,0,1,1,1,1,1,0,7,25,
Pakistan,2020,NF,1,0,1,3,0,5,1,2,1,1,2,2,2,3,14,2,0,1,1,1,1,1,0,7,26,
Pakistan,2019,NF,1,0,1,3,0,5,1,2,1,1,2,2,2,3,14,2,0,1,1,1,1,1,0,7,26,
Pakistan,2018,NF,0,1,1,3,0,5,2,2,1,1,2,2,2,3,15,2,0,1,1,1,1,1,0,7,27,
Pakistan,2017,NF,0,1,2,3,0,6,2,2,1,1,2,2,2,3,15,2,0,2,1,1,1,0,1,8,29,
Pakistan,2016,NF,0,1,3,3,0,7,2,2,1,1,2,2,2,3,15,2,1,0,1,1,1,1,2,9,31,
Pakistan,2015,NF,0,1,1,3,0,5,2,2,1,1,2,2,2,3,15,2,1,2,1,1,1,1,2,11,31,
Pakistan,2014,NF,0,1,1,3,0,5,2,2,1,1,2,2,2,3,15,2,1,1,1,2,1,1,2,11,31,
Pakistan,2013,NF,0,1,1,3,0,5,2,2,1,1,2,2,2,3,15,2,1,2,1,2,1,2,2,13,33,
Pakistan,2012,NF,1,0,2,3,0,6,3,2,1,2,2,2,2,3,17,2,1,2,1,2,1,3,2,14,37,
Pakistan,2011,PF,1,0,3,4,1,9,3,3,1,2,2,2,2,3,18,2,1,5,2,2,1,3,2,18,45,
Philippines,2022,PF,4,1,6,4,2,17,6,3,4,2,1,1,3,6,26,3,2,3,4,3,4,2,1,22,65,
Philippines,2021,PF,4,1,6,4,2,17,6,3,4,2,1,1,3,6,26,3,2,3,4,3,4,2,1,22,65,
Philippines,2020,PF,4,1,5,4,2,16,6,3,4,2,1,1,3,6,26,2,2,3,4,3,4,3,1,22,64,
Philippines,2019,PF,4,1,5,4,2,16,6,3,4,2,1,2,3,6,27,3,2,3,4,3,4,3,1,23,66,
Philippines,2018,PF,4,1,5,4,2,16,6,4,4,2,2,2,3,6,29,3,2,4,4,3,4,3,1,24,69,
Philippines,2017,F,4,1,5,4,2,16,6,4,4,2,2,2,3,6,29,3,2,5,4,4,4,4,1,27,72,
Philippines,2016,F,3,1,6,4,2,16,6,4,4,2,3,2,3,6,30,3,2,5,4,4,4,4,2,28,74,
Philippines,2015,F,3,1,5,4,2,15,6,4,4,2,3,2,3,6,30,3,2,5,4,4,4,4,2,28,73,
Philippines,2014,F,2,1,6,4,2,15,6,4,4,2,3,2,3,6,30,3,2,5,4,4,4,4,2,28,73,
Philippines,2013,F,2,1,6,4,2,15,6,4,4,2,3,2,3,6,30,3,3,5,4,4,4,4,3,30,75,
Philippines,2012,F,2,1,6,4,2,15,6,4,4,3,4,2,3,4,30,3,4,6,4,4,4,4,3,32,77,
Russia,2022,NF,5,2,2,2,0,11,1,0,0,1,0,1,1,2,6,1,0,1,1,1,1,1,0,6,23,
Russia,2021,NF,5,2,3,2,0,12,1,1,0,2,0,1,2,3,10,1,1,1,2,1,1,1,0,8,30,
Russia,2020,NF,5,2,2,2,0,11,1,1,0,2,0,1,2,4,11,1,1,1,2,1,1,1,0,8,30,
Russia,2019,NF,5,2,2,2,1,12,1,1,0,2,0,1,2,4,11,1,1,1,2,1,1,1,0,8,31,
Russia,2018,NF,5,2,3,2,1,13,1,1,0,2,0,1,2,4,11,1,1,2,2,1,1,1,0,9,33,
Russia,2017,NF,5,2,4,2,1,14,2,1,0,2,0,1,2,4,12,1,1,1,2,1,1,1,0,8,34,
Russia,2016,NF,5,2,5,2,1,15,2,1,0,2,0,1,2,4,12,1,1,1,2,1,1,1,0,8,35,
Russia,2015,NF,5,2,5,2,1,15,2,1,0,2,0,1,2,4,12,1,1,2,2,1,2,1,1,11,38,
Russia,2014,PF,5,2,5,2,1,15,2,1,0,2,0,1,3,4,13,2,1,2,2,1,2,1,1,12,40,
Russia,2013,PF,5,2,5,2,1,15,3,1,1,2,0,2,3,4,16,2,1,3,3,2,2,2,0,15,46,
Russia,2012,PF,4,2,5,2,1,14,4,1,1,2,0,2,3,4,17,2,2,3,3,2,3,2,0,17,48,
Russia,2011,PF,3,2,5,2,1,13,4,2,1,2,1,2,3,3,18,2,1,3,3,2,3,2,1,17,48,
Rwanda,2022,NF,3,1,5,3,1,13,3,2,1,0,1,1,1,2,11,1,1,1,3,1,2,2,2,13,37,
Rwanda,2021,NF,3,1,5,3,1,13,3,2,1,0,1,1,1,2,11,1,1,2,3,1,2,2,2,14,38,
Rwanda,2020,NF,3,1,5,3,1,13,3,2,1,0,1,1,1,3,12,1,1,2,3,1,2,2,2,14,39,
Rwanda,2019,PF,3,1,5,3,1,13,3,2,1,0,1,1,1,3,12,1,1,2,3,2,2,3,2,16,41,
Rwanda,2018,PF,3,1,5,4,1,14,3,2,1,1,1,1,1,3,13,2,2,2,3,2,2,3,2,18,45,
Rwanda,2017,PF,3,1,5,4,2,15,3,2,1,1,1,1,2,2,13,2,2,3,3,2,3,2,2,19,47,
Rwanda,2016,PF,3,1,5,4,2,15,3,2,1,1,2,1,2,2,14,2,2,3,3,2,3,3,2,20,49,
Rwanda,2015,PF,2,1,5,4,2,14,3,2,1,2,2,1,2,2,15,2,2,4,3,2,3,3,2,21,50,
Rwanda,2014,PF,1,1,5,4,2,13,3,2,2,2,2,1,2,2,16,2,2,4,3,2,3,3,2,21,50,
Rwanda,2013,PF,1,1,5,4,2,13,4,2,2,2,2,1,2,2,17,2,1,4,3,3,3,3,3,22,52,
Rwanda,2012,PF,1,0,5,4,2,12,4,2,2,2,2,2,1,1,16,2,1,4,4,3,3,1,3,21,49,
Rwanda,2011,PF,1,0,4,4,2,11,4,2,2,2,2,2,1,1,16,2,1,5,4,3,3,2,3,23,50,
Saudi Arabia,2022,NF,6,2,3,1,0,12,1,1,1,0,0,0,1,4,8,0,0,0,1,0,1,1,1,4,24,
Saudi Arabia,2021,NF,6,2,3,1,0,12,1,1,1,0,0,0,1,4,8,0,0,0,1,0,1,1,1,4,24,
Saudi Arabia,2020,NF,6,2,3,1,0,12,1,1,2,0,0,0,1,4,9,0,0,1,1,0,1,1,1,5,26,
Saudi Arabia,2019,NF,5,2,3,1,0,11,1,1,2,0,0,1,1,4,10,0,0,0,1,0,1,1,1,4,25,
Saudi Arabia,2018,NF,5,2,3,1,0,11,1,1,2,0,0,1,1,4,10,0,0,0,1,1,1,2,1,6,27,
Saudi Arabia,2017,NF,5,2,3,1,0,11,1,1,2,1,0,1,1,4,11,0,0,0,1,1,1,2,1,6,28,
Saudi Arabia,2016,NF,5,2,3,1,0,11,1,1,2,1,0,1,1,4,11,0,0,0,1,1,1,2,1,6,28,
Saudi Arabia,2015,NF,4,2,3,1,0,10,1,1,2,1,0,1,1,4,11,0,0,0,1,1,1,2,1,6,27,
Saudi Arabia,2014,NF,4,2,3,1,0,10,1,1,2,1,0,1,1,4,11,0,0,0,1,1,0,2,2,6,27,
Saudi Arabia,2013,NF,4,2,4,1,0,11,1,1,2,1,0,1,1,4,11,0,0,1,1,1,0,3,2,8,30,
Saudi Arabia,2012,NF,4,2,4,1,0,11,1,1,1,1,0,1,1,3,9,1,0,1,2,1,0,2,2,9,29,
Saudi Arabia,2011,NF,4,2,4,1,0,11,1,0,2,0,0,1,1,3,8,1,0,2,2,2,0,3,1,11,30,
Serbia,2022,F,6,2,6,4,4,22,5,3,3,2,2,2,3,5,25,4,3,4,4,3,3,3,1,25,72,
Serbia,2021,F,5,2,6,4,4,21,5,3,3,2,2,2,3,5,25,4,3,4,4,3,3,3,1,25,71,
Singapore,2022,PF,6,3,5,4,1,19,4,1,1,2,2,1,3,3,17,1,2,3,2,2,3,3,2,18,54,
Singapore,2021,PF,6,3,5,4,1,19,4,1,1,2,2,1,3,3,17,1,2,3,2,2,3,3,2,18,54,
Singapore,2020,PF,6,3,5,4,1,19,4,1,1,2,2,1,3,3,17,1,2,3,2,2,3,3,2,18,54,
Singapore,2019,PF,6,3,5,4,1,19,4,1,1,2,2,1,3,4,18,2,2,3,2,2,3,3,2,19,56,
Singapore,2018,PF,6,3,5,4,1,19,5,1,1,2,3,1,4,4,21,2,2,3,2,2,3,3,2,19,59,
Singapore,2017,PF,6,3,5,4,1,19,5,1,1,2,3,1,4,4,21,2,2,2,2,2,3,4,2,19,59,
Singapore,2016,PF,6,3,5,4,1,19,5,1,1,2,3,1,4,4,21,2,2,2,2,2,3,4,2,19,59,
Singapore,2015,PF,6,3,5,4,1,19,5,1,1,2,3,1,4,4,21,2,2,2,2,3,3,3,2,19,59,
Singapore,2014,PF,6,3,5,4,1,19,5,1,1,2,3,1,4,4,21,2,2,3,2,3,3,3,2,20,60,
South Africa,2022,F,5,1,6,4,2,18,6,3,3,3,3,2,3,6,29,5,2,5,3,2,3,4,2,26,73,
South Africa,2021,F,4,1,6,4,2,17,6,3,3,3,3,2,3,6,29,4,2,6,3,2,3,4,3,27,73,
South Africa,2020,F,3,1,6,4,2,16,6,3,3,3,3,2,3,6,29,4,2,5,3,2,3,4,2,25,70,
South Africa,2019,F,4,1,6,4,2,17,6,3,3,3,2,2,3,6,28,5,2,6,3,2,3,4,2,27,72,
South Africa,2018,F,4,1,6,4,2,17,6,3,3,4,3,2,3,5,29,5,2,6,3,3,3,5,2,29,75,
South Africa,2017,F,4,1,6,4,2,17,6,3,3,4,3,2,3,5,29,5,2,6,3,3,3,5,2,29,75,
South Africa,2016,F,4,1,6,4,2,17,6,3,3,4,3,2,3,5,29,5,2,6,3,3,3,5,2,29,75,
South Africa,2015,F,4,1,6,4,2,17,6,3,2,4,3,2,3,4,27,5,2,6,3,3,3,5,2,29,73,
South Africa,2014,F,4,1,6,4,3,18,6,3,2,4,3,2,3,4,27,5,2,6,3,3,3,5,2,29,74,
South Africa,2013,F,4,1,6,4,3,18,6,3,2,3,4,2,3,4,27,5,2,6,3,3,3,5,2,29,74,
South Africa,2012,F,3,1,6,4,3,17,6,3,2,3,4,2,3,4,27,5,2,6,3,4,3,5,2,30,74,
South Africa,2011,F,2,1,6,6,3,18,5,3,2,3,4,2,3,4,26,5,2,6,3,4,3,5,2,30,74,
South Korea,2022,PF,6,3,6,5,2,22,3,2,2,3,2,3,3,6,24,3,2,3,3,2,3,3,2,21,67,
South Korea,2021,PF,6,3,6,5,2,22,3,2,2,3,2,3,3,6,24,3,2,3,3,2,3,3,2,21,67,
South Korea,2020,PF,6,3,6,5,2,22,3,2,2,3,2,3,3,6,24,3,2,3,2,2,3,3,2,20,66,
South Korea,2019,PF,6,3,6,5,2,22,3,2,2,3,1,3,3,6,23,3,2,2,2,2,3,3,2,19,64,
South Korea,2018,PF,6,3,6,5,2,22,3,2,2,3,1,2,3,6,22,3,2,2,2,2,4,3,2,20,64,
South Korea,2017,PF,6,3,6,5,2,22,3,2,2,3,1,2,3,6,22,3,2,2,2,2,4,4,2,21,65,
South Korea,2016,PF,6,3,6,5,2,22,3,2,2,3,1,1,3,5,20,3,2,2,2,2,4,5,2,22,64,
South Korea,2015,PF,6,3,6,5,2,22,3,2,2,3,1,2,3,5,21,4,2,2,2,3,4,5,1,23,66,
South Korea,2014,PF,6,3,6,5,2,22,3,2,2,3,1,2,3,5,21,4,2,2,2,3,4,5,2,24,67,
South Korea,2013,PF,6,3,6,5,2,22,3,2,2,3,2,2,3,5,22,4,2,2,2,3,4,5,2,24,68,
South Korea,2012,PF,6,3,5,5,3,22,3,2,3,2,3,2,3,5,23,4,2,2,0,3,4,5,1,21,66,
South Korea,2011,PF,6,3,5,5,3,22,3,2,3,2,3,2,3,5,23,4,2,3,0,3,4,5,2,23,68,
Sri Lanka,2022,PF,2,1,3,3,0,9,4,3,2,2,2,2,3,4,22,2,1,3,2,2,3,3,1,17,48,
Sri Lanka,2021,PF,3,1,4,3,0,11,4,3,2,2,2,2,3,5,23,2,1,3,2,2,3,3,1,17,51,
Sri Lanka,2020,PF,4,1,4,3,0,12,4,3,2,2,2,2,3,4,22,2,1,3,2,2,3,3,2,18,52,
Sri Lanka,2019,PF,4,1,2,3,0,10,3,3,2,2,3,2,3,4,22,1,1,3,2,2,3,3,2,17,49,
Sri Lanka,2018,PF,4,1,2,3,0,10,3,3,2,2,3,2,3,4,22,2,1,5,2,2,3,4,2,21,53,
Sri Lanka,2017,PF,4,1,4,3,0,12,4,3,2,2,3,2,3,4,23,2,1,6,2,2,3,4,2,22,57,
Sri Lanka,2016,PF,3,1,4,3,0,11,4,3,2,2,3,2,3,4,23,2,1,6,2,2,3,4,2,22,56,
Sri Lanka,2015,PF,3,1,4,3,0,11,5,3,1,2,3,2,3,3,22,2,1,4,2,2,3,4,2,20,53,
Sri Lanka,2014,PF,2,1,4,3,0,10,3,3,0,1,2,2,2,2,15,2,1,3,2,2,3,2,2,17,42,
Sri Lanka,2013,PF,2,1,4,3,0,10,3,3,0,1,2,2,2,2,15,2,1,3,2,2,3,2,2,17,42,
Sri Lanka,2012,PF,1,1,4,3,0,9,3,3,0,1,3,3,2,2,17,2,2,3,2,2,3,2,3,19,45,
Sudan,2022,NF,1,0,1,3,0,5,3,2,2,1,0,0,2,3,13,0,1,3,3,1,0,2,1,11,29,
Sudan,2021,NF,1,0,2,3,0,6,5,2,2,1,0,0,2,3,15,1,1,3,3,1,0,2,1,12,33,
Sudan,2020,NF,1,0,1,3,0,5,5,2,2,1,0,0,2,3,15,1,1,2,3,1,0,2,0,10,30,
Sudan,2019,NF,1,0,1,3,0,5,3,2,2,1,0,0,2,2,12,0,1,2,3,1,0,1,0,8,25,
Sudan,2018,NF,1,0,4,3,0,8,5,2,2,1,0,0,2,4,16,1,1,2,3,1,0,3,0,11,35,
Sudan,2017,NF,1,1,4,3,0,9,5,3,2,1,0,0,2,4,17,1,1,2,3,1,0,2,0,10,36,
Sudan,2016,NF,1,1,4,3,0,9,5,3,2,1,0,0,2,4,17,1,1,2,3,1,0,2,0,10,36,
Sudan,2015,NF,1,1,2,3,0,7,5,2,2,1,0,0,2,4,16,1,1,3,3,1,1,2,0,12,35,
Sudan,2014,NF,2,1,1,3,0,7,4,2,2,2,0,0,2,4,16,1,1,3,3,1,1,1,1,12,35,
Sudan,2013,NF,1,2,2,3,0,8,4,2,2,2,0,0,2,4,16,1,1,3,3,2,1,1,1,13,37,
Syria,2020,NF,1,1,3,1,0,6,1,1,0,0,1,0,1,4,8,0,0,1,2,0,0,0,0,3,17,
Syria,2019,NF,1,1,3,1,0,6,1,1,0,0,1,0,1,4,8,0,0,1,2,0,0,0,0,3,17,
Syria,2018,NF,1,1,2,1,0,5,2,1,0,0,1,0,1,4,9,0,0,1,2,0,0,0,0,3,17,
Syria,2017,NF,1,0,1,0,0,2,1,1,0,1,1,0,1,4,9,0,0,1,2,0,0,0,0,3,14,
Syria,2016,NF,1,0,0,0,0,1,1,1,0,1,1,0,1,4,9,0,0,1,2,0,0,0,0,3,13,
Syria,2015,NF,1,0,0,0,0,1,1,1,0,1,1,0,1,4,9,0,0,1,2,0,0,0,0,3,13,
Syria,2014,NF,0,0,0,0,0,0,1,1,0,1,1,0,1,4,9,0,0,1,2,0,0,0,0,3,12,
Syria,2013,NF,0,1,0,0,0,1,1,2,0,1,1,1,1,3,10,0,0,1,2,1,0,0,0,4,15,
Syria,2012,NF,1,1,0,0,0,2,1,2,0,1,1,1,1,3,10,0,0,1,2,1,0,0,1,5,17,
Taiwan,2022,F,6,3,6,5,4,24,5,3,4,3,2,3,4,6,30,5,2,4,3,3,3,4,1,25,79,
Taiwan,2021,F,6,3,6,5,4,24,6,3,4,3,2,3,4,6,31,5,2,4,3,3,3,4,1,25,80,
Thailand,2022,NF,5,2,5,4,0,16,3,1,1,1,1,2,2,3,14,0,0,1,2,1,1,2,2,9,39,
Thailand,2021,NF,5,2,5,4,0,16,3,0,1,1,1,2,2,3,13,0,0,0,2,1,1,1,2,7,36,
Thailand,2020,NF,5,2,5,4,0,16,3,0,0,1,1,2,2,3,12,0,0,1,2,1,1,0,2,7,35,
Thailand,2019,NF,5,2,5,4,0,16,3,0,0,1,1,2,1,3,11,1,0,1,2,1,1,0,2,8,35,
Thailand,2018,NF,5,2,5,4,0,16,2,0,0,1,2,2,1,3,11,0,0,0,2,1,1,2,2,8,35,
Thailand,2017,NF,4,2,5,4,0,15,2,0,0,1,2,2,1,3,11,0,0,0,2,1,1,1,2,7,33,
Thailand,2016,NF,4,2,5,4,0,15,2,0,0,1,2,2,2,3,12,0,0,0,2,1,1,1,2,7,34,
Thailand,2015,NF,4,2,5,4,1,16,2,0,1,1,2,2,2,3,13,0,0,0,2,2,1,1,2,8,37,
Thailand,2014,NF,3,2,4,4,1,14,2,0,1,2,2,2,2,3,14,0,0,1,2,2,1,2,2,10,38,
Thailand,2013,PF,3,2,5,4,1,15,2,0,1,2,2,2,2,3,14,1,0,1,2,1,1,3,2,11,40,
Thailand,2012,NF,3,1,5,4,1,14,2,1,1,2,1,2,2,3,14,1,0,1,2,2,1,2,2,11,39,
Thailand,2011,NF,3,1,4,4,1,13,1,1,0,2,1,1,2,4,12,2,0,2,2,2,1,3,2,14,39,
The Gambia,2021,PF,2,1,4,4,1,12,6,2,2,2,2,2,3,3,22,2,1,4,2,2,1,4,3,19,53,
The Gambia,2020,PF,1,1,4,4,0,10,6,2,2,2,2,2,3,3,22,2,1,4,2,2,1,3,2,17,49,
The Gambia,2019,PF,1,1,4,4,0,10,6,2,2,2,2,2,3,4,23,2,1,3,2,2,1,2,2,15,48,
The Gambia,2018,PF,1,1,4,3,0,9,6,2,2,2,2,1,2,4,21,2,1,3,2,2,1,2,2,15,45,
The Gambia,2017,NF,1,1,0,3,0,5,5,2,1,1,2,1,1,2,15,1,1,3,2,2,1,2,1,13,33,
The Gambia,2016,NF,1,1,2,3,0,7,3,2,1,1,2,1,1,2,13,1,1,3,2,2,1,2,1,13,33,
The Gambia,2015,NF,1,1,2,3,0,7,3,3,1,1,2,1,1,2,14,1,1,3,2,2,1,3,1,14,35,
The Gambia,2014,NF,1,1,1,3,0,6,3,4,1,1,2,1,1,1,14,1,1,3,2,2,1,4,1,15,35,
Tunisia,2022,PF,4,2,5,3,2,16,5,2,3,2,3,3,3,5,26,2,1,3,3,2,3,3,2,19,61,
Tunisia,2021,PF,4,2,5,3,2,16,6,2,3,3,3,3,3,5,28,3,1,3,3,2,3,2,2,19,63,
Tunisia,2020,PF,4,2,5,3,2,16,6,2,3,3,3,3,3,5,28,3,1,3,3,2,3,3,2,20,64,
Tunisia,2019,PF,4,2,5,3,2,16,6,2,3,3,3,3,3,6,29,3,1,2,3,2,3,3,2,19,64,
Tunisia,2018,PF,4,2,5,3,2,16,6,1,3,3,3,3,3,5,27,3,1,2,3,2,3,3,2,19,62,
Tunisia,2017,PF,4,2,5,2,2,15,6,1,3,3,3,3,3,5,27,3,1,2,3,3,3,3,2,20,62,
Tunisia,2016,PF,4,2,5,2,2,15,6,1,3,3,3,3,3,5,27,3,1,2,3,3,3,3,2,20,62,
Tunisia,2015,PF,4,2,5,2,2,15,6,1,3,3,3,3,3,5,27,3,1,2,3,3,3,3,2,20,62,
Tunisia,2014,PF,4,2,5,2,1,14,6,1,3,3,3,3,3,5,27,3,1,2,3,3,3,3,2,20,61,
Tunisia,2013,PF,3,2,5,2,1,13,6,1,3,3,3,3,3,5,27,2,1,2,3,3,3,3,2,19,59,
Tunisia,2012,PF,3,2,4,1,1,11,4,1,3,3,2,2,3,5,23,2,1,2,3,3,3,4,2,20,54,
Tunisia,2011,NF,2,1,1,0,0,4,0,1,0,1,1,1,1,2,7,1,1,2,2,1,0,1,0,8,19,
Turkey,2022,NF,4,2,4,3,1,14,1,0,1,1,1,1,2,3,10,1,1,0,2,1,0,2,1,8,32,
Turkey,2021,NF,5,2,4,3,1,15,1,0,1,1,1,1,2,3,10,1,1,1,2,1,0,2,1,9,34,
Turkey,2020,NF,4,2,3,3,1,13,1,0,1,1,1,1,2,4,11,1,1,2,2,1,0,3,1,11,35,
Turkey,2019,NF,5,2,4,3,1,15,1,0,1,1,1,1,2,4,11,1,1,2,2,1,0,3,1,11,37,
Turkey,2018,NF,5,2,3,3,1,14,1,0,1,1,1,1,1,4,10,1,1,1,2,1,0,3,1,10,34,
Turkey,2017,NF,5,2,1,3,1,12,2,0,1,2,1,1,1,4,12,1,1,1,2,1,0,3,1,10,34,
Turkey,2016,NF,5,2,1,3,1,12,2,0,1,2,1,2,2,4,14,2,1,2,2,1,2,3,0,13,39,
Turkey,2015,PF,4,2,2,3,1,12,2,0,1,2,2,2,2,4,15,3,1,2,2,1,2,3,1,15,42,
Turkey,2014,PF,3,2,2,3,1,11,2,1,1,2,3,2,2,4,17,3,1,3,2,2,3,2,1,17,45,
Turkey,2013,PF,3,2,3,3,2,13,2,1,1,2,3,2,2,4,17,3,1,3,3,2,3,4,2,21,51,
Turkey,2012,PF,3,2,3,3,2,13,3,1,1,2,3,2,2,4,18,3,1,5,3,2,3,4,2,23,54,
Turkey,2011,PF,3,2,3,3,2,13,3,1,1,2,3,2,3,4,19,3,1,5,3,2,3,4,2,23,55,
Uganda,2022,PF,1,1,4,5,1,12,3,2,2,2,2,1,3,4,19,2,2,3,2,2,3,3,2,19,50,
Uganda,2021,PF,1,1,3,5,1,11,3,2,2,2,2,1,3,4,19,2,2,3,2,2,3,3,2,19,49,
Uganda,2020,PF,2,1,6,5,1,15,4,2,2,2,3,1,3,4,21,2,2,3,2,2,3,4,2,20,56,
Uganda,2019,PF,2,0,6,5,1,14,5,2,2,2,3,2,3,4,23,2,2,3,2,2,3,3,2,19,56,
Uganda,2018,PF,2,1,6,5,1,15,6,2,3,2,3,2,3,4,25,2,2,3,2,2,4,3,1,19,59,
Uganda,2017,PF,1,1,6,5,1,14,6,2,3,3,3,2,3,4,26,2,2,3,3,2,4,2,1,19,59,
Uganda,2016,PF,1,1,4,5,1,12,4,3,3,3,3,2,3,3,24,2,2,4,3,2,4,3,2,22,58,
Uganda,2015,PF,1,1,6,5,1,14,6,3,3,3,4,2,3,4,28,3,2,4,3,2,4,3,1,22,64,
Uganda,2014,PF,1,1,6,5,1,14,6,3,3,3,4,2,3,4,28,3,2,6,3,2,4,3,1,24,66,
Uganda,2013,PF,1,1,6,5,1,14,6,3,3,2,4,2,3,4,27,3,2,4,3,3,4,4,2,25,66,
Uganda,2012,PF,1,1,5,6,1,14,6,3,3,2,4,2,3,4,27,3,2,4,3,3,4,4,2,25,66,
Ukraine,2022,PF,4,2,4,5,3,18,3,2,2,3,2,2,2,5,21,3,2,3,4,3,3,1,1,20,59,
Ukraine,2021,PF,5,2,5,5,3,20,3,2,2,3,2,2,2,5,21,3,2,3,4,3,3,2,1,21,62,
Ukraine,2020,PF,5,2,4,5,3,19,3,2,2,3,2,2,2,5,21,3,2,2,4,3,4,2,1,21,61,
Ukraine,2019,PF,5,2,4,4,2,17,3,2,2,2,2,2,2,4,19,3,2,2,4,3,4,2,0,20,56,
Ukraine,2018,PF,5,2,3,4,2,16,3,2,2,2,2,2,2,4,19,3,2,2,4,3,4,2,0,20,55,
Ukraine,2017,PF,5,2,3,4,2,16,3,2,2,2,2,2,2,4,19,3,2,2,4,3,4,2,0,20,55,
Ukraine,2016,PF,4,2,5,4,2,17,3,2,3,2,2,2,4,6,24,3,2,2,4,3,4,3,0,21,62,
Ukraine,2015,PF,4,2,5,4,2,17,4,2,3,2,2,2,4,6,25,3,2,3,4,3,4,1,1,21,63,
Ukraine,2014,PF,4,2,5,4,2,17,5,3,3,2,2,2,4,6,27,3,2,5,4,3,4,1,1,23,67,
Ukraine,2013,F,4,2,6,4,2,18,6,3,3,2,3,2,4,5,28,3,2,5,4,4,4,2,2,26,72,
Ukraine,2012,F,4,2,6,4,2,18,6,3,2,3,3,2,4,4,27,3,2,5,4,4,4,3,3,28,73,
United Arab Emirates,2022,NF,6,1,3,2,0,12,1,1,1,0,1,1,1,3,9,0,0,2,1,0,0,2,2,7,28,
United Arab Emirates,2021,NF,6,1,3,2,0,12,1,1,1,0,1,1,1,3,9,0,0,1,1,0,0,2,2,6,27,
United Arab Emirates,2020,NF,6,1,3,2,0,12,1,1,2,0,1,1,1,3,10,0,0,2,1,0,0,2,2,7,29,
United Arab Emirates,2019,NF,6,1,3,2,0,12,1,1,2,0,1,1,1,3,10,0,0,1,1,0,0,2,2,6,28,
United Arab Emirates,2018,NF,6,1,3,2,0,12,1,1,2,1,1,2,1,3,12,0,0,1,1,1,0,2,2,7,31,
United Arab Emirates,2017,NF,6,1,3,2,0,12,1,1,2,1,1,2,1,3,12,0,0,1,1,1,0,2,2,7,31,
United Arab Emirates,2016,NF,5,1,3,2,0,11,2,1,2,1,1,2,1,3,13,0,1,2,1,1,0,1,2,8,32,
United Arab Emirates,2015,NF,5,1,3,2,0,11,2,1,2,1,1,2,1,3,13,0,1,2,1,1,0,1,2,8,32,
United Arab Emirates,2014,NF,5,1,3,2,0,11,2,1,2,1,1,2,1,3,13,0,1,2,2,1,0,1,2,9,33,
United Arab Emirates,2013,NF,6,1,3,2,0,12,2,1,2,1,1,2,1,3,13,0,1,2,2,1,0,1,2,9,34,
United Kingdom,2022,F,6,3,6,5,4,24,4,3,3,3,4,3,4,6,30,5,2,5,2,2,3,4,2,25,79,
United Kingdom,2021,F,6,2,6,5,4,23,5,3,3,3,3,3,4,6,30,5,2,5,2,2,3,4,2,25,78,
United Kingdom,2020,F,6,2,6,5,4,23,5,3,3,3,3,3,4,6,30,5,2,5,2,2,3,4,2,25,78,
United Kingdom,2019,F,6,2,5,5,4,22,5,3,3,3,3,3,4,6,30,5,2,5,2,2,3,4,2,25,77,
United Kingdom,2018,F,6,2,6,5,4,23,5,3,3,3,3,3,4,5,29,5,2,5,2,2,3,4,2,25,77,
United Kingdom,2017,F,6,2,6,5,4,23,5,3,3,3,4,3,4,5,30,5,2,4,2,2,3,4,1,23,76,
United Kingdom,2016,F,6,2,6,5,4,23,5,3,3,3,4,3,4,5,30,5,2,4,2,2,3,4,2,24,77,
United Kingdom,2015,F,6,2,6,5,4,23,4,3,3,3,4,3,4,5,29,5,2,4,2,2,3,4,2,24,76,
United Kingdom,2014,F,6,2,6,5,4,23,4,3,3,3,4,3,4,5,29,5,3,3,2,2,3,4,2,24,76,
United Kingdom,2013,F,6,2,6,5,4,23,4,3,3,3,4,3,4,5,29,5,3,3,2,2,3,5,2,25,77,
United Kingdom,2012,F,6,2,6,5,4,23,4,3,3,3,4,3,4,5,29,5,2,3,2,3,3,5,2,25,77,
United Kingdom,2011,F,6,2,6,6,4,24,4,3,2,3,4,2,4,5,27,5,2,3,2,3,3,5,2,25,76,
United States,2022,F,6,2,6,4,3,21,6,3,4,3,2,3,3,6,30,6,2,4,3,2,4,3,1,25,76,
United States,2021,F,6,2,6,4,3,21,6,3,4,3,2,3,3,5,29,6,2,4,3,2,4,3,1,25,75,
United States,2020,F,6,2,6,4,3,21,6,3,4,3,2,3,4,5,30,6,2,4,3,2,4,3,1,25,76,
United States,2019,F,6,2,6,4,3,21,6,3,4,3,2,3,4,6,31,6,2,4,3,2,4,3,1,25,77,
United States,2018,F,6,2,6,4,3,21,6,3,4,3,2,3,4,6,31,6,2,4,3,3,4,3,1,26,78,
United States,2017,F,6,2,6,4,4,22,6,3,4,3,2,3,4,6,31,6,2,4,3,3,4,3,1,26,79,
United States,2016,F,6,2,6,4,4,22,6,3,4,3,4,3,4,6,33,6,2,4,3,3,4,4,1,27,82,
United States,2015,F,6,2,6,4,4,22,6,3,4,3,4,3,4,6,33,6,2,4,3,2,4,4,1,26,81,
United States,2014,F,6,2,6,4,3,21,6,3,4,3,4,3,4,6,33,6,2,4,3,2,4,5,1,27,81,
United States,2013,F,6,2,5,4,4,21,6,3,4,4,4,3,4,6,34,6,2,4,4,2,4,5,1,28,83,
United States,2012,F,6,2,5,4,4,21,6,3,4,4,4,3,4,6,34,6,3,5,4,4,4,5,2,33,88,
United States,2011,F,5,2,6,4,4,21,6,3,4,4,4,3,4,5,33,6,3,5,4,4,4,5,2,33,87,
Uzbekistan,2022,NF,4,1,3,1,0,9,2,1,0,1,2,0,2,3,11,0,1,1,1,1,0,2,1,7,27,
Uzbekistan,2021,NF,4,1,3,1,0,9,3,1,0,1,2,0,2,3,12,0,1,1,1,1,0,2,1,7,28,
Uzbekistan,2020,NF,3,0,3,1,0,7,3,1,0,1,2,0,2,3,12,0,1,2,1,1,0,2,1,8,27,
Uzbekistan,2019,NF,3,0,3,1,0,7,2,1,0,1,2,0,1,3,10,0,1,2,1,1,0,2,2,9,26,
Uzbekistan,2018,NF,3,0,3,1,0,7,1,1,0,1,2,0,1,3,9,0,1,2,1,1,0,2,2,9,25,
Uzbekistan,2017,NF,3,0,2,1,0,6,1,1,0,0,2,0,1,3,8,0,1,2,1,1,0,2,2,9,23,
Uzbekistan,2016,NF,3,0,1,1,0,5,1,1,0,0,2,0,1,2,7,0,1,2,1,1,0,2,2,9,21,
Uzbekistan,2015,NF,3,0,2,1,0,6,1,1,0,0,2,0,1,2,7,0,1,2,1,1,0,2,2,9,22,
Uzbekistan,2014,NF,2,0,2,1,0,5,1,1,0,0,2,0,1,2,7,0,1,2,1,1,0,2,2,9,21,
Uzbekistan,2013,NF,2,0,2,1,0,5,1,1,0,0,2,0,1,2,7,0,1,2,1,1,1,2,2,10,22,
Uzbekistan,2012,NF,2,0,2,2,0,6,1,1,0,0,2,0,1,2,7,0,1,2,1,1,1,2,2,10,23,
Venezuela,2022,NF,2,0,4,1,0,7,2,1,0,1,1,1,2,4,12,1,0,2,2,2,2,2,0,11,30,
Venezuela,2021,NF,2,0,3,1,0,6,2,1,0,1,1,1,2,4,12,1,0,2,2,2,2,1,0,10,28,
Venezuela,2020,NF,2,0,2,1,0,5,2,1,0,2,1,1,2,4,13,1,0,2,2,2,2,1,0,10,28,
Venezuela,2019,NF,2,0,1,1,0,4,2,1,0,3,1,1,2,4,14,1,0,2,2,2,3,1,1,12,30,
Venezuela,2018,NF,2,0,2,1,0,5,3,1,0,3,1,1,2,5,16,1,0,2,2,3,3,1,1,13,34,
Venezuela,2017,NF,2,0,3,1,0,6,3,2,0,3,1,1,2,5,17,1,1,1,2,3,3,2,1,14,37,
Venezuela,2016,PF,3,0,3,1,0,7,3,2,1,3,1,1,2,5,18,2,1,1,2,3,3,2,1,15,40,
Venezuela,2015,PF,2,1,3,2,0,8,3,2,1,3,1,1,2,4,17,2,2,2,2,3,3,3,1,18,43,
Venezuela,2014,PF,3,1,2,2,0,8,3,2,1,3,1,1,2,4,17,2,2,4,2,3,3,3,0,19,44,
Venezuela,2013,PF,3,1,3,2,0,9,4,3,1,2,1,1,3,4,19,2,2,4,2,3,3,3,0,19,47,
Venezuela,2012,PF,3,1,4,2,0,10,4,3,1,3,2,1,3,4,21,2,2,5,2,3,3,3,1,21,52,
Venezuela,2011,PF,3,1,4,2,0,10,4,3,1,3,3,1,3,4,22,2,2,3,2,3,3,4,3,22,54,
Vietnam,2022,NF,4,2,4,2,0,12,2,0,0,1,0,0,1,2,6,0,0,0,1,1,0,1,1,4,22,
Vietnam,2021,NF,4,2,4,2,0,12,2,0,0,1,0,0,1,2,6,0,0,0,1,1,0,1,1,4,22,
Vietnam,2020,NF,4,2,3,2,0,11,2,0,0,1,0,0,1,3,7,0,0,0,1,1,0,1,1,4,22,
Vietnam,2019,NF,4,2,4,2,0,12,2,0,0,1,0,0,1,3,7,0,0,0,1,1,1,1,1,5,24,
Vietnam,2018,NF,4,2,4,2,0,12,2,0,0,1,0,0,1,3,7,0,0,0,1,1,1,1,1,5,24,
Vietnam,2017,NF,4,2,3,2,0,11,2,0,0,1,0,0,1,3,7,0,0,1,1,1,1,1,1,6,24,
Vietnam,2016,NF,4,2,3,2,0,11,2,0,0,1,0,0,1,3,7,0,0,1,2,0,1,1,1,6,24,
Vietnam,2015,NF,4,2,4,2,0,12,2,0,0,1,0,0,1,2,6,0,0,1,2,0,1,1,1,6,24,
Vietnam,2014,NF,3,2,4,2,0,11,2,0,0,1,0,1,1,2,7,0,0,1,2,0,1,1,1,6,24,
Vietnam,2013,NF,3,2,4,2,0,11,2,0,0,1,0,1,1,2,7,1,0,0,2,1,1,1,1,7,25,
Vietnam,2012,NF,3,1,3,2,0,9,2,1,0,1,1,1,1,2,9,1,0,1,2,1,0,2,2,9,27,
Vietnam,2011,NF,3,1,3,2,0,9,2,2,0,1,1,1,1,2,10,1,0,1,2,1,0,2,1,8,27,
Zambia,2022,PF,2,1,5,5,2,15,5,2,3,2,2,2,3,4,23,2,1,3,3,3,2,3,3,20,58,
Zambia,2021,PF,2,1,5,5,2,15,6,2,3,2,2,2,3,4,24,2,1,3,3,3,2,3,3,20,59,
Zambia,2020,PF,1,1,4,5,2,13,6,2,3,2,2,2,3,4,24,2,2,3,3,3,2,4,3,22,59,
Zambia,2019,PF,1,1,5,5,2,14,6,2,3,2,2,2,3,4,24,2,2,2,3,3,2,3,3,20,58,
Zambia,2018,PF,1,1,5,5,2,14,6,2,3,2,2,2,3,4,24,2,2,2,3,3,4,1,3,20,58,
Zambia,2017,PF,1,1,4,5,2,13,5,2,3,2,2,2,3,4,23,2,2,3,3,3,4,4,2,23,59,
Zambia,2016,PF,1,1,5,5,2,14,6,3,3,2,2,2,3,4,25,2,2,4,3,3,4,3,2,23,62,
Zambia,2015,PF,1,1,5,5,2,14,5,3,2,2,2,2,3,4,23,2,2,4,3,3,4,3,2,23,60,
Zambia,2014,PF,0,1,5,5,2,13,4,3,2,2,2,2,3,4,22,2,2,3,3,3,4,3,2,22,57,
Zimbabwe,2022,PF,1,0,4,3,0,8,6,3,2,2,2,1,3,4,23,2,1,3,3,2,2,3,2,18,49,
Zimbabwe,2021,PF,1,0,4,3,0,8,6,3,1,2,2,1,3,4,22,2,1,3,3,2,1,2,2,16,46,
Zimbabwe,2020,PF,1,0,5,3,0,9,6,3,1,2,2,1,3,4,22,2,1,3,3,2,0,2,2,15,46,
Zimbabwe,2019,PF,1,0,3,3,0,7,4,3,1,2,2,1,3,3,19,2,1,3,3,2,0,3,2,16,42,
Zimbabwe,2018,PF,1,1,5,3,0,10,6,3,2,2,2,1,3,3,22,2,1,3,2,2,0,3,2,15,47,
Zimbabwe,2017,PF,1,1,4,3,0,9,4,3,1,2,3,1,3,3,20,2,1,3,2,2,0,3,2,15,44,
Zimbabwe,2016,PF,1,1,5,3,0,10,4,2,1,2,3,1,3,3,19,2,1,3,2,2,0,3,2,15,44,
Zimbabwe,2015,PF,1,1,5,3,0,10,4,2,1,2,3,1,3,3,19,2,1,3,2,2,0,3,2,15,44,
Zimbabwe,2014,PF,2,1,4,3,0,10,4,3,1,2,3,1,3,3,20,2,1,3,2,2,0,3,2,15,45,
Zimbabwe,2013,PF,2,1,4,2,0,9,5,2,2,2,3,1,3,3,21,2,1,3,1,2,1,4,2,16,46,
Zimbabwe,2012,PF,1,1,4,2,0,8,5,2,1,2,3,2,3,3,21,2,1,3,1,3,1,4,2,17,46,
Zimbabwe,2011,PF,1,1,4,3,0,9,5,2,1,2,3,2,3,2,20,2,1,3,1,3,1,4,2,17,46,